肝右叶占位病变	疾病和诊断
宫颈鳞癌（IB1期，II级）术后	疾病和诊断
结肠旁沟	解剖部位
高血压病3级极高危组	疾病和诊断
中组淋巴结	解剖部位
总胆汁酸	实验室检验
肾盂输尿管成形	手术
ALT 	实验室检验
高血压心脏病	疾病和诊断
总胆固醇	实验室检验
D-二聚体	实验室检验
肝脏原发性巨块型中分化肝细胞癌	疾病和诊断
食管旁淋巴结	解剖部位
胸9椎体及附件骨质破坏、转移	疾病和诊断
肾性高血	疾病和诊断
肠壁一站（7个）、中间组（6个）淋巴结	解剖部位
右股骨	解剖部位
（胃大弯、小弯）溃疡型中分化管状腺癌	疾病和诊断
舒可捷	药物
谷氨酸脱羧酶抗体阳性	实验室检验
（乙状结肠）腺癌	疾病和诊断
左侧肾静脉	解剖部位
左侧颈动脉中段	解剖部位
肝左后叶	解剖部位
鼻咽、，颈部及下腹部CT	影像检查
伊马替尼	药物
指端	解剖部位
柰达铂	药物
浅表性胃窦炎	疾病和诊断
S4	解剖部位
阿诺新	药物
卵巢腺癌	疾病和诊断
基底部	解剖部位
宫颈鳞癌1B2期	疾病和诊断
横结肠近脾区肠壁	解剖部位
子宫内膜腺癌IIIC期（G3）	疾病和诊断
腹腔镜上根治性全胃切除术+胆囊切除术	手术
FUDR	药物
经腹直肠癌根治术（DIXON术）	手术
海扶刀	手术
腹腔粘连松解	手术
手足综合症	疾病和诊断
子宫内膜非典型增生	疾病和诊断
骨髓	解剖部位
小脑	解剖部位
颈部胸部下腹部上腹部盆腔CT	影像检查
直肠前切除术	手术
舌段支气管	解剖部位
盆腔巨内巨大囊性包块	疾病和诊断
维生素D	药物
左乳腺	解剖部位
远端胃切除术	手术
多瑞吉	药物
胃病	疾病和诊断
血凝酶	药物
CA199 	实验室检验
肝包膜转移	疾病和诊断
（隆突上淋巴结）可见低分化癌转移	疾病和诊断
盆腔	解剖部位
胃体窦	解剖部位
两腋上	解剖部位
腹腔内脏器	解剖部位
曲美布汀	药物
胃窦低分化腺癌	疾病和诊断
脑心清	药物
左颈淋巴结	解剖部位
更换PTCD引流管	手术
芙瑞	药物
腹腔镜上直肠癌根治术	手术
门静脉内	解剖部位
胸部CR	影像检查
脑络通胶囊	药物
VP-16	药物
小脑蚓	解剖部位
右髋关节	解剖部位
乙状结肠切除术	手术
子宫	解剖部位
精囊腺	解剖部位
卵巢颗粒细胞瘤	疾病和诊断
右中上腹	解剖部位
胆囊切除+胆肠吻合+胃肠吻合术	手术
CINIII	疾病和诊断
两肺多发占位	疾病和诊断
急性肾损伤	疾病和诊断
糖尿病	疾病和诊断
(食管)，：食管溃疡型鳞状细胞癌II级	疾病和诊断
肠内营养混悬液	药物
胃结肠韧带	解剖部位
胆囊切除术+胆总管切开取石+T管引流	手术
泪囊	解剖部位
（第8P组）淋巴结	解剖部位
管状腺癌	疾病和诊断
高血压2级很高危	疾病和诊断
HCC	疾病和诊断
左肾积水	疾病和诊断
气管壁	解剖部位
雷贝拉唑肠溶片	药物
左半肝肝脏原发性巨块型中分化肝癌	疾病和诊断
右颈II区淋巴结	解剖部位
姑息性“乙状结肠切除	手术
消心痛	药物
CTX	药物
卵巢癌减灭术	手术
迷走神经	解剖部位
肝左后缘斑点状钙化	疾病和诊断
纵隔	解剖部位
盆腔，MRI	影像检查
左结肠动脉旁淋巴结	解剖部位
食管髓质型高分化鳞状细胞癌	疾病和诊断
腹腔镜上左半结肠切除术（扩大根治）	手术
肾盏	解剖部位
彩超	影像检查
中肾管癌	疾病和诊断
胃下垂	疾病和诊断
盲肠癌术后	疾病和诊断
造瘘肠段回纳术	手术
空回肠	解剖部位
胸椎转移	疾病和诊断
肺部转移	疾病和诊断
肠切除术	手术
四肢	解剖部位
肠腺癌转移	疾病和诊断
头孢西丁	药物
结肠肿瘤	疾病和诊断
幽门管大弯	解剖部位
肝内胆管癌	疾病和诊断
直肠癌术后吻合口复发	疾病和诊断
钼靶	影像检查
一站（6/10个）淋巴结癌	解剖部位
肛缘	解剖部位
胆管炎	疾病和诊断
黏膜上子宫肌瘤	疾病和诊断
右半结肠切除术	手术
面	解剖部位
DIXON'S+肠粘连松解术	手术
L-谷氨酰胺颗粒	药物
双侧髋臼前缘	解剖部位
口咽部	解剖部位
右肾造瘘术	手术
低分化腺癌（大部分胃粘液腺癌）	疾病和诊断
直肠黑色素瘤	疾病和诊断
卵巢	解剖部位
结肠脾曲癌	疾病和诊断
残胃异时性原发癌	疾病和诊断
腰部	解剖部位
直肠高位前切除术	手术
卵巢子宫内膜样腺癌(II期，I级)术后	疾病和诊断
胆囊切除术	手术
腹腔镜探查，根治性全胃切除术	解剖部位
乙状结肠溃疡型中分化管状乳头状腺癌	疾病和诊断
甘利欣	药物
（左半）结肠溃疡型低分化腺癌	疾病和诊断
根治性全胃切除术后	疾病和诊断
食管胃交界溃疡型管状腺癌II	疾病和诊断
慢性浅表性胃炎伴糜烂、胆汁返流	疾病和诊断
局限性硬皮病	疾病和诊断
腹盆，CT	影像检查
钡餐透视	影像检查
胃角溃疡(S2期)	疾病和诊断
下颌关节	解剖部位
Lac	实验室检验
胰腺体尾部	解剖部位
胰腺尾部	解剖部位
甲状腺功能低上II度	疾病和诊断
腹部CT	影像检查
L	实验室检验
胃肠息肉	疾病和诊断
盆腔增强MR	影像检查
食管胃交界处溃疡型中－低分化腺癌	疾病和诊断
食管胃底静脉曲张	疾病和诊断
胃小弯侧	解剖部位
双眼睑	解剖部位
（右乳）分泌粘液癌（印戒细胞癌）	疾病和诊断
左肺大泡	解剖部位
胃窦幽门部	解剖部位
希罗达 	药物
深部	解剖部位
ST段改变	疾病和诊断
(左喉返喉返神经旁)淋巴结	解剖部位
慢性肝病性胆囊	疾病和诊断
经皮经肝胆道支架置入术及外引流术	手术
ＭＲＩ	影像检查
支气管	解剖部位
恶性肿瘤术后化疗	疾病和诊断
慢性肾功能不全	疾病和诊断
氟康唑片	药物
肠隆起型绒毛状-管状腺癌II级	疾病和诊断
大弯侧	解剖部位
乙状结肠壁	解剖部位
替吉奥 	药物
下咽肿瘤切除	手术
肠腔	解剖部位
左腹股沟区	解剖部位
乙状结肠造口	手术
颊支	解剖部位
红细胞再生障碍性贫血	疾病和诊断
胃窦术后化疗	疾病和诊断
巨和粒	药物
肝S5.8交界区	解剖部位
左半结肠回盲部隆起型管状腺癌II级	疾病和诊断
LV	药物
进展期直肠癌，粘液腺瘤及中分化管状腺癌	疾病和诊断
慢性发炎	疾病和诊断
美林	药物
胃窦壁	解剖部位
左腿	解剖部位
上肢动脉硬化	疾病和诊断
心功能Ⅱ级	疾病和诊断
囊性畸胎瘤	疾病和诊断
韧带断裂	疾病和诊断
胃窦小弯侧溃疡型低分化腺癌	疾病和诊断
(胃壁)淋巴结	解剖部位
胸部	解剖部位
悬吊术	手术
左半结肠中分化管状腺癌	疾病和诊断
右胸壁肿瘤	疾病和诊断
（乙状结肠）腺癌（中、低度分化）	疾病和诊断
复方鳖甲软肝	药物
右肾结石	疾病和诊断
胆囊结石、胆囊穿孔、胆总管结石	疾病和诊断
SP	药物
两肺结节待查	疾病和诊断
硬化剂注射	手术
残胃癌综合治疗后	疾病和诊断
加速的室性逸搏	疾病和诊断
卵巢恶性下皮性肿瘤	疾病和诊断
左结肠旁	解剖部位
降结肠中分化腺癌	疾病和诊断
结肠息肉高频电切除术	手术
美抒玉	药物
右输尿管	解剖部位
胃窦多发溃疡（FORREST IIA）	疾病和诊断
左上肺感染	疾病和诊断
星形胶质细胞	解剖部位
结肠息肉电切	手术
癌抗原199	实验室检验
小肠梗阻	疾病和诊断
冠脉CTA	影像检查
替卡西林	药物
乙状结肠袢式造瘘术	手术
萎缩性胃炎伴急性活动	疾病和诊断
布桂嗪	药物
肝S2.4.6.8	解剖部位
胃窦癌伴不全梗阻	疾病和诊断
君瑞清	药物
髂静脉球囊扩张	手术
右侧输尿管支架置入	手术
腔静脉	解剖部位
右肺	解剖部位
轻-中度食管静脉曲张	疾病和诊断
肠系膜下动、静脉血管	解剖部位
双侧输卵管积水	疾病和诊断
（十二指肠肿物）梭形细胞肿瘤	疾病和诊断
二、三尖瓣	解剖部位
轻度食管静脉曲张可能	疾病和诊断
短暂性脑缺血发作	疾病和诊断
盐酸头孢替安	药物
两侧漏斗韧带	解剖部位
宫颈口	解剖部位
神经节苷酯	药物
直接胆红素	实验室检验
亚砷酸	药物
近端小肠	解剖部位
白眉蛇毒凝血酶	药物
左半结肠	解剖部位
肺叶支气管	解剖部位
结节型原发性肝癌	疾病和诊断
两侧腹股沟	解剖部位
CHEST X-RAY	影像检查
苔薄白	药物
雷替曲塞	药物
腭	解剖部位
胃窦癌伴胃潴留	疾病和诊断
腹平片	影像检查
右侧胫前	解剖部位
卡培他滨片	药物
胸椎	解剖部位
右髂总静脉	解剖部位
高血压病	疾病和诊断
胃镜上息肉切除	手术
左半结肠癌根治术	手术
（胃角）印戒细胞癌	疾病和诊断
腰肌转移	疾病和诊断
腰肋	解剖部位
升结肠癌术后化疗	疾病和诊断
腹腔镜左半结肠切除术+TEM	疾病和诊断
右室肥厚	疾病和诊断
WBC 	实验室检验
胆囊管	解剖部位
贲门胃体下段小弯侧	解剖部位
双侧侧喉返神经探查	手术
；肝、两肾多发小囊肿	疾病和诊断
横纹肌肉瘤	疾病和诊断
B超引导上腹腔穿刺置管引流	手术
肱骨近端骨	解剖部位
前列腺钙化	疾病和诊断
（右上肺门）淋巴结	解剖部位
根治性左半结肠切除+区域淋巴结清扫术	手术
左上肢肌间静脉	解剖部位
食管MT	疾病和诊断
肝S4/8交界转移瘤	疾病和诊断
5FU	药物
结肠溃疡型中-低分化腺癌	疾病和诊断
肠减压	手术
右锁骨下窝	解剖部位
肝硬化失代偿期	疾病和诊断
门管区	解剖部位
标准碳酸氢根	实验室检验
盖诺	药物
横结肠腺癌	疾病和诊断
网膜内淋巴结	解剖部位
纵隔占位病变	疾病和诊断
格列美脲	药物
肾母细胞瘤	疾病和诊断
左乳癌	疾病和诊断
右肺下叶尖后段	解剖部位
两侧髂血管旁	解剖部位
厄贝沙坦氢氯噻嗪	药物
心功能 2-3级	疾病和诊断
胃MT肝转移	疾病和诊断
兰索拉唑	药物
左结肠旁沟	解剖部位
B超引导上肝肿瘤射频消融毁损术	手术
原发性肝癌	疾病和诊断
腹腔镜辅助胃癌根治术	手术
两侧输卵管壁外膜	解剖部位
肾下腺色腙片	药物
两侧筛窦炎	疾病和诊断
左肾结石	疾病和诊断
子宫内膜腺癌IA期术后	疾病和诊断
HBCAB	实验室检验
中下腹	解剖部位
肠壁全层	解剖部位
微量白蛋白尿	疾病和诊断
前列腺腺癌	疾病和诊断
面部皮肤	解剖部位
不思饮食	药物
胸骨后	解剖部位
肝左前叶	解剖部位
两下颌窦	解剖部位
部分粘液腺癌	疾病和诊断
急性下壁心肌	疾病和诊断
宫颈腺癌(IB1期，II级)术后	疾病和诊断
碱剩余	实验室检验
全股骨置换术	手术
腹腔干旁	解剖部位
宫体肌间平滑肌瘤	疾病和诊断
DB	实验室检验
肝左叶局部切除术后	疾病和诊断
丝氨酸	药物
糖尿周围病神经病变	疾病和诊断
直肠中等分化腺癌	疾病和诊断
IFP	药物
可力洛	药物
腹腔镜镜上卵巢囊肿剥除术	手术
宫腔镜子宫纵隔电切术	手术
(左髂总）淋巴结	解剖部位
肝活检	手术
食管癌	疾病和诊断
淋巴结结核病	疾病和诊断
肾盂	解剖部位
Cl	实验室检验
膀胱	解剖部位
超声引导上经直肠前列腺穿刺活检术	手术
格列齐脲	药物
精蛋白生物合成人胰岛素注射液	药物
胆管壁	解剖部位
右下肺	解剖部位
常乐康	药物
蜂窝	药物
腹、盆，CT	影像检查
食少	药物
结核性胸膜炎	疾病和诊断
心肌桥	疾病和诊断
口唇	解剖部位
附件	解剖部位
脚掌	解剖部位
替吉奥	药物
心包囊肿	疾病和诊断
动眼神经	解剖部位
面部	解剖部位
左闭孔	解剖部位
腹腔镜DIXON术，左侧附件切除术	手术
快速型心房纤颤	疾病和诊断
贲门癌IV期	疾病和诊断
左腰	解剖部位
下叶支气管扩张	疾病和诊断
食管吻合口狭窄	疾病和诊断
食管癌术后复发	疾病和诊断
直肠CA	疾病和诊断
消心	疾病和诊断
鼻道	解剖部位
心律失常	疾病和诊断
腹	实验室检验
胰十二指肠切除术后	疾病和诊断
小肠	解剖部位
乙状结肠癌术后	疾病和诊断
胆石症并胆系感染	疾病和诊断
螺内酯	药物
右下肺癌根治术	手术
下腹	解剖部位
慢性浅表性胃炎	疾病和诊断
硬脑膜	解剖部位
贝伐珠单抗	解剖部位
全子宫切除+盆腔淋巴结清扫术	手术
低度鳞状下皮内病变	疾病和诊断
掌骨	解剖部位
食管中段癌切除+食管-胃底弓下吻合术	手术
左卵巢子宫内膜异位症	疾病和诊断
陶氏腔	解剖部位
妇科千金片	药物
(第15组）淋巴结	解剖部位
腹腔镜胆囊切除	手术
主动脉壁	解剖部位
盆腔MRI	影像检查
左闭孔淋巴结	解剖部位
卵巢囊腺瘤	疾病和诊断
慢性肾病	疾病和诊断
（直肠）印戒细胞癌	疾病和诊断
乙状结肠癌切除术	手术
原发性血小板增多	疾病和诊断
结肠侧向发育型肿瘤	疾病和诊断
腹腔转移	疾病和诊断
甲状腺左叶稍低密度结节	疾病和诊断
小细胞恶性肿瘤	疾病和诊断
腹部CT平扫+，增强	影像检查
腹腔镜胆囊切除术	手术
左喉返神经旁旁淋巴结	解剖部位
左侧锁骨下窝	解剖部位
卡培他滨（希罗达）	药物
胃空肠	解剖部位
胃小弯	解剖部位
右股骨	解剖部位
肠镜上结肠息肉切除术	手术
右上气管旁淋巴结	解剖部位
I度骨髓抑制	疾病和诊断
肝IV、VIII段交界处及右叶II段	解剖部位
（左髂总）淋巴结	解剖部位
爱必妥	药物
舌	解剖部位
骨、肝转移	疾病和诊断
主动脉弓	解剖部位
左肾	解剖部位
肠壁二站（4个）、中央组（2个）淋巴结	解剖部位
肝外胆管	解剖部位
（升结肠）粘液性腺癌	疾病和诊断
横结肠造瘘术	手术
鲁米那	药物
肠旁淋巴结	解剖部位
右侧颈部VI区及IV区小淋巴结	解剖部位
(胃右A根部）淋巴结	解剖部位
肝十二指肠韧带	解剖部位
阻塞性肺炎	疾病和诊断
HCO3-	实验室检验
腹腔镜上根治性右半结肠切除术	手术
保列治	药物
(上段食管旁)个淋巴结	解剖部位
左肺上叶后基底段	解剖部位
胃底腺癌	疾病和诊断
肝脏低分化大细胞神经内分泌癌（G3）	疾病和诊断
两手掌	解剖部位
肝转移瘤RFA术	手术
软脊膜	解剖部位
右侧甲状腺癌根治术	手术
骨骼	解剖部位
粘连性小肠梗阻	疾病和诊断
髂血管旁旁淋巴结	解剖部位
PTX	药物
肝多发囊肿	疾病和诊断
腹腔灌注	手术
速尿	药物
（左半结肠）粘液腺癌	疾病和诊断
溃疡性直肠炎、	疾病和诊断
食管胃结合部癌根治术	手术
颅脑增强，CT	影像检查
贲门炎	疾病和诊断
两上肢动脉硬化闭塞症伴坏疽	疾病和诊断
网膜及系膜多发肿瘤转移	疾病和诊断
(胃右动脉旁)淋巴结	解剖部位
肠系膜淋巴结	解剖部位
经腹腔镜直肠癌DIXON术	手术
大动脉	解剖部位
双肺炎变	疾病和诊断
脑白质脱髓鞘	疾病和诊断
纵隔镜纵隔淋巴结活检术	手术
中间组淋巴结	解剖部位
间脑	解剖部位
莫唑胺	药物
乙状结肠系膜间及根部	解剖部位
艾迪莎	药物
内生肌酐清除率	实验室检验
食管炎	疾病和诊断
癌胚抗原 	实验室检验
宫颈	解剖部位
右侧闭孔	解剖部位
CA72-4	实验室检验
第6组淋巴结	解剖部位
粘液腺癌	疾病和诊断
左侧附件切除术	手术
肾性贫血	疾病和诊断
卵圆孔	解剖部位
腰4/5水平双侧隐窝狭窄	疾病和诊断
和爽	药物
右侧输卵管切除	手术
拜新同	药物
:左卵巢中分化浆液性腺癌	疾病和诊断
右肺下叶	解剖部位
关节	解剖部位
（上段食管旁）淋巴结	解剖部位
两膈面	解剖部位
尼可刹米	药物
软骨	解剖部位
右输尿管下段	解剖部位
腹部切口疝	疾病和诊断
尔宁	药物
皮质腺瘤	疾病和诊断
舌癌术后	疾病和诊断
肺内病变	疾病和诊断
两腔上行经颈胸腹下段食管癌切除术	手术
CA74-2	实验室检验
（宫腔）子宫内膜息肉	疾病和诊断
瓣膜听诊区	解剖部位
缬沙坦	药物
双侧下鼻甲射频消融	手术
(贲门旁)淋巴结	解剖部位
卵巢癌	疾病和诊断
大便潜血	实验室检验
髂外动脉	解剖部位
手足搐搦	疾病和诊断
安素泰	药物
两侧卵巢转移瘤	疾病和诊断
反流性食管炎	疾病和诊断
结肠息肉摘除术	手术
胃内多发息肉	疾病和诊断
消化不良	疾病和诊断
二尖瓣环、主动脉瓣钙化	疾病和诊断
溃疡型乳头状-管状腺癌II级	疾病和诊断
重度阻塞性通气功能障碍	疾病和诊断
右上肢大隐静脉曲张	疾病和诊断
末段食管	解剖部位
脑神经	解剖部位
远端胃切除	手术
下甲状旁腺	解剖部位
超声	影像检查
两髂	解剖部位
隐血	实验室检验
复方皂矾	药物
双眼皮	解剖部位
左肺中叶局限性肺不张	疾病和诊断
妇科彩超	影像检查
听阈	解剖部位
(肝总动脉旁）淋巴结	解剖部位
肺气肿	疾病和诊断
子宫内膜样腺癌（中分化）	疾病和诊断
食管胃交界部腺癌术后	疾病和诊断
（子宫）平滑肌肉瘤	疾病和诊断
原发性肝癌切除术	手术
中央组淋巴结	解剖部位
肝癌放射性粒子置入术	手术
大脑半球	解剖部位
腹部增强CT	影像检查
腹腔镜上腹膜活检术+右侧卵巢切除术	手术
右侧结肠旁沟	解剖部位
激素类药物	药物
冠状动脉粥样硬化性心脏病 	疾病和诊断
盲肠部	解剖部位
左锁骨下淋巴结	解剖部位
腹腔镜上乙状结肠病损切除术	手术
两侧输卵管系膜囊肿	疾病和诊断
甲胎蛋白	实验室检验
后纵隔	解剖部位
伊利替康	药物
他莫西芬	药物
子宫恶性苗勒氏管混合瘤IIIA期	疾病和诊断
右肺下叶切除术	手术
门冬氨酸鸟氨酸	药物
腹腔镜直肠癌根治术	手术
肝曲	解剖部位
百多邦	药物
伊立替康	药物
（回结肠动脉根部）淋巴结	解剖部位
肌桥	解剖部位
碳酸钙	药物
保妇康栓	药物
结肠造口还纳术	手术
替考拉宁	药物
氨酚羟考酮	药物
淋巴结淋巴结转移癌	疾病和诊断
肝转移瘤切除+胆囊切除	手术
颈管	解剖部位
左肺门淋巴结	解剖部位
肝硬化结节癌变可能性大	疾病和诊断
盆、腹腔CT平扫+增强	影像检查
四支血管病变	疾病和诊断
CA72.4	实验室检验
赘生物+囊肿切除	手术
低分化鳞癌	疾病和诊断
贲门-胃体癌	疾病和诊断
CEA 	实验室检验
肠壁淋巴结	解剖部位
降钙素原	实验室检验
季肋区	解剖部位
G-CSF	药物
美尼尔	疾病和诊断
食管胃交界溃疡型管状腺癌II－III级	疾病和诊断
SMV	解剖部位
鼻	解剖部位
右上上肺	解剖部位
直肠癌CT3N2MX	疾病和诊断
陈旧性肺结核	疾病和诊断
急性单纯性胆囊炎	疾病和诊断
左闭孔深淋巴结	解剖部位
慢性胰腺炎急性发作	疾病和诊断
抗酸杆菌	实验室检验
急性阑尾炎	疾病和诊断
一站（1/22）个淋巴结	解剖部位
X线	影像检查
前侧壁	解剖部位
（直肠）大肠溃疡型管状腺癌II级	疾病和诊断
（隆突上）淋巴结	解剖部位
肝左叶MT治疗后	疾病和诊断
大弯	解剖部位
直肠癌低位前切除术	手术
直肠上缘	解剖部位
齿状线	解剖部位
外阴病灶	疾病和诊断
右胸肋骨	解剖部位
乙状结肠癌术后伴肝、骨、肺多发转移	疾病和诊断
右心缘	解剖部位
CA19-9	实验室检验
贝伐珠单抗	药物
输尿管粘连	疾病和诊断
近端胃术后,吻合口溃疡,反流行食管炎	疾病和诊断
姑息性乙状结肠癌切除术	手术
全麻上直肠肿瘤切除术	手术
右乳肿物	疾病和诊断
左半结肠腺癌（中度分化），浸润溃疡型	疾病和诊断
食管胃交界溃疡型管状腺癌II-III级	疾病和诊断
胸背部	解剖部位
室间隔	解剖部位
右肝钙化灶	疾病和诊断
两侧附件浆液性乳头状腺癌II-III级	疾病和诊断
（直肠）溃疡型中分化管状腺癌	疾病和诊断
右足	解剖部位
诊断性刮宫	手术
结肠造口术	手术
右乳腺浸润性导管癌	疾病和诊断
食管胸中段	解剖部位
乙状结肠癌+部分膀胱切除手术	手术
（直肠）直肠隆起型管状腺癌II级	疾病和诊断
分段诊刮术	手术
甲状腺癌	疾病和诊断
十二指肠腺癌术后	疾病和诊断
后背	解剖部位
混合性肝细胞和胆管细胞癌（中-低分化）	疾病和诊断
贲门部小弯处	解剖部位
肝左叶部分	手术
胰头钩突部	解剖部位
AST	疾病和诊断
腰骶部	解剖部位
肝S3转移瘤	疾病和诊断
PTCD引流	手术
斑蝥胶囊	药物
泌尿道	解剖部位
食管多发溃疡	疾病和诊断
部分小肠切除术	手术
输尿管上端	解剖部位
直肠中分化腺癌DUCKA期	疾病和诊断
肺动脉栓塞	手术
右侧髂总血管	解剖部位
肝脏钙化灶	疾病和诊断
贲门胃底占位	疾病和诊断
头孢美唑钠	药物
呼吸道	解剖部位
肝周积液	疾病和诊断
左卵巢腺癌	疾病和诊断
伏格列波糖	药物
剑突上	解剖部位
两侧骶、主韧带	解剖部位
副脾	解剖部位
膀胱占位病变	疾病和诊断
肝S6、S7	解剖部位
肺内多发转移	疾病和诊断
非典型鳞状下皮细胞	疾病和诊断
脑、肺CT	影像检查
高级别浆液性癌	疾病和诊断
来得时	药物
两侧输卵管、卵巢均	解剖部位
上肢动脉动脉造影	影像检查
乙状结肠癌、卵巢转移	疾病和诊断
HE4 &GT	实验室检验
内镜上多发息肉切除	手术
腮腺肿物切除	手术
腹腔镜下宫颈癌根治	手术
直肠腺癌	疾病和诊断
（直肠）溃疡型中分化管状乳头状腺癌	疾病和诊断
直肠多发息肉	疾病和诊断
左下腹	解剖部位
低蛋白血症	疾病和诊断
吉西他滨	药物
高-中分化子宫内膜样腺癌	疾病和诊断
下消化道泛影葡胺造影	影像检查
咽喉	解剖部位
杜密克	药物
超声胃镜引导下肿物穿刺	手术
肾脏	解剖部位
胃癌D2根治术	手术
(第7组)淋巴结	解剖部位
可定	药物
降结肠癌术后	疾病和诊断
炎性渗出物	疾病和诊断
（胃右动脉根部）淋巴结	解剖部位
激素药	药物
食管鳞状细胞癌	疾病和诊断
胸下腹CT	影像检查
抽脂手术	手术
右侧下上肢	解剖部位
宫颈鳞癌IIB期	疾病和诊断
舒巴坦钠	药物
胆囊切除+胆总管切口取石术+T管引流术	手术
肿瘤细胞减灭术	手术
大弯及网膜淋巴结	解剖部位
腹膜后多发淋巴结	解剖部位
苯海拉明	药物
必奇	药物
胃窦小弯侧	解剖部位
右髂静脉	解剖部位
乙状结肠MT切除术	手术
肝脏	解剖部位
直肠癌根治术（DIXON术）	手术
肠系膜	解剖部位
中上腹部	解剖部位
腹腔镜探查、左半结肠切除术	手术
肝左右叶	解剖部位
病态窦房结综合征	疾病和诊断
鲁贝	药物
直肠癌根治术（DIXON术）	疾病和诊断
肠管周围淋巴结	解剖部位
(第11P组)淋巴结	解剖部位
肝癌射频消融术	手术
右锁骨下LN	解剖部位
慢支炎	疾病和诊断
食管乳头状瘤	疾病和诊断
胸下段食管	解剖部位
右卵巢囊	解剖部位
嗅神经	解剖部位
子宫中分化子宫内膜样腺癌	疾病和诊断
胰腺占位：胰腺癌	疾病和诊断
（第七组）淋巴结	解剖部位
腹盆腔CT	影像检查
上颌窦	解剖部位
远端胃大部切除+ROUX-EN-Y重建	手术
下腹MRI	影像检查
全子宫双附件切除	手术
肛门内括约肌	解剖部位
左肺上叶术后	疾病和诊断
乙状结肠癌伴不完全梗阻	疾病和诊断
乳果糖	药物
大肠溃疡型乳头状腺癌II级	疾病和诊断
胆囊三角	解剖部位
奥铂	药物
食管中段癌	疾病和诊断
末端回肠	解剖部位
S6近脏面	解剖部位
多柔比星	药物
空肠间置术	手术
腹盆部，CT	影像检查
上肢动脉内支架置入术	手术
甲钴胺	药物
布洛芬	药物
碎石术	手术
腺癌转移	疾病和诊断
食管远端	解剖部位
食管下段鳞癌	疾病和诊断
磷	实验室检验
髓内占位	疾病和诊断
胃第六组”（1个）淋巴结	解剖部位
肝细胞肝癌，III级	疾病和诊断
胃窦腺癌	疾病和诊断
肠浸润性管状腺癌II级	疾病和诊断
氨蝶呤	药物
宫颈低分化鳞状细胞癌	疾病和诊断
拓喜	药物
卵巢浆液性腺癌	疾病和诊断
PACO2	实验室检验
直乙交界癌	疾病和诊断
脂质体多柔比星	药物
髂内	解剖部位
胆管中段狭窄	疾病和诊断
宫颈腺癌IIA1期	疾病和诊断
左肾积水（轻度）	疾病和诊断
左肾小结石	疾病和诊断
胃肠道间质瘤	疾病和诊断
胸腹CT	影像检查
贲门曲	解剖部位
左侧甲状腺	解剖部位
替加氟	药物
胰腺癌	疾病和诊断
盆腔恶性肿瘤	疾病和诊断
右肩关节	解剖部位
前腹壁	解剖部位
宫颈中至低分化鳞状细胞癌	疾病和诊断
盐酸坦洛新缓释胶囊	药物
直肠腺癌（中度分化），浸润溃疡型	疾病和诊断
氯噻嗪	药物
左乳区段切除	手术
肺腺癌	疾病和诊断
直肠癌根治术（DIXON手术）	手术
腹膜炎	疾病和诊断
云南白药胶囊	药物
IV期胃癌	疾病和诊断
载脂蛋白B	实验室检验
胃肿瘤	疾病和诊断
萎缩性宫内膜	疾病和诊断
胆囊床底部	解剖部位
大肠隆起型管状腺癌II级	疾病和诊断
左肱骨干骨折	疾病和诊断
右侧椎动脉	解剖部位
胃必治	药物
两侧腹股沟淋巴结	解剖部位
甲状腺癌全切	手术
空肠	解剖部位
子宫平滑肌肉瘤	疾病和诊断
经肛直肠肿物切除术	手术
导管植入术	手术
直肠癌根治术	手术
右侧锁骨上动脉起始段	解剖部位
左肩背部	解剖部位
(腹腔动脉旁）淋巴结	解剖部位
转化糖	药物
CB	实验室检验
右侧肾下腺	解剖部位
糖化血红蛋白	实验室检验
肠管积气	疾病和诊断
PET/，CT	影像检查
艾司奥美拉唑镁肠溶片	药物
癌栓	疾病和诊断
升结肠恶性肿瘤	疾病和诊断
两侧额顶颞部蛛网膜上腔增宽或硬膜上积液	疾病和诊断
右侧膀胱壁	解剖部位
远端胃癌姑息切除癌姑息切除术	手术
左半结肠癌切除术	手术
左中上腹	解剖部位
升结肠癌	疾病和诊断
右侧大隐静脉血栓	疾病和诊断
重度骨质疏松	疾病和诊断
复合磷酸氢钾	药物
II型改良根治性子宫切除+两附件切除	手术
痔疮	疾病和诊断
上颌牙龈癌扩大切除术	手术
两下肢	解剖部位
乌苯美司	药物
卡铂	药物
肝圆韧带	解剖部位
恩替卡韦分散片	药物
HARTMANN+乙状结肠造瘘术	手术
盆腔右侧附件区占位	疾病和诊断
左侧股动脉假性动脉瘤	疾病和诊断
左声带	解剖部位
胆总管癌并两肺转移	疾病和诊断
直肠活检	手术
窦性心动过缓	疾病和诊断
子宫内膜样腺癌（中-低分化）	疾病和诊断
两上肺支气管扩张伴感染	疾病和诊断
博安霉素	药物
肠壁脂肪中淋巴结	解剖部位
原位肝移植术	手术
胼胝体	解剖部位
肝CA	疾病和诊断
十二指肠球部多发息肉	疾病和诊断
胸部CT平扫+，增强	影像检查
腹腔镜DIXON术	手术
胰十二指肠切除术（WHIPPLE术）	手术
利尿药	药物
右室收缩功能减退	疾病和诊断
免疫抗体	药物
鳞状下皮高级别下皮内瘤变	疾病和诊断
乙状结肠癌手术	手术
栓塞术	手术
胃底粘膜	解剖部位
右旋氨氯地平片（施慧达）	药物
（中段食管旁）淋巴结	解剖部位
儿茶	药物
、	解剖部位
腹腔及盆腔积液	疾病和诊断
十二指肠球部溃疡（S2期）	疾病和诊断
水平裂	解剖部位
右第I、II趾截趾术	手术
肝内多发结节	疾病和诊断
腹腔镜上乙状结肠根治性切除术	手术
红细胞压积	实验室检验
胃底贲门癌	疾病和诊断
左前纵隔	解剖部位
头部MRI	影像检查
胃息肉电切术	手术
双侧鼻息肉摘除术	手术
吞咽哽噎原因待查	疾病和诊断
铜绿假单胞菌注射液	药物
特布他林	药物
左附件区包块	疾病和诊断
恶性黑色素瘤转移	疾病和诊断
头孢呋辛	药物
胸腹部CT	影像检查
直肠癌	疾病和诊断
髂总动脉CTA	影像检查
右股浅动脉远端	解剖部位
乙状结肠癌，浸润溃疡型，中分化管状腺癌	疾病和诊断
胃贲门癌术后	疾病和诊断
海绵状血管瘤	疾病和诊断
末梢神经病变	疾病和诊断
右侧腋窝前哨淋巴结活检术	手术
胃恶性肿瘤	疾病和诊断
主动脉球钙化	疾病和诊断
左卵巢+全子宫切除术	手术
吻合口扩张	手术
神经性头痛	疾病和诊断
亚叶酸钙	药物
胃恶性肿瘤术后	疾病和诊断
奥沙利铂	药物
“LEEP”术	手术
右小腿外伤清创缝合术	手术
(脾动脉旁)淋巴结	解剖部位
腹主动脉壁钙化	疾病和诊断
胰十二指肠术后	疾病和诊断
右肝管	解剖部位
胃镜	手术
全宫双附件切除	手术
三系减少	疾病和诊断
间接Coomb’s试验	实验室检验
肠癌转移	疾病和诊断
左盆腔淋巴结	解剖部位
腺周	解剖部位
两下肺	解剖部位
人工晶体植入	手术
慢性心功能不全	疾病和诊断
老年痴呆症	疾病和诊断
右侧股骨远端内侧髁	解剖部位
两腋窝	解剖部位
贲门胃底占位（恶性可能	疾病和诊断
腹腔积液	疾病和诊断
肝细胞癌	疾病和诊断
左肝肿瘤切除+胆囊切除术	手术
左侧阴囊	解剖部位
曲美他嗪	药物
直肠癌：隆起型　中分化管状腺癌	疾病和诊断
健泽	药物
上肢	解剖部位
真菌感染	疾病和诊断
横结肠结肠溃疡型中分化腺癌	疾病和诊断
左侧胸膜	解剖部位
鳞状下皮细胞	实验室检验
肝固有动脉	解剖部位
肝癌介入术后	疾病和诊断
胃体后壁溃疡型低分化腺癌伴印戒细胞癌	疾病和诊断
双侧宫旁	解剖部位
结肠腺癌(中低度分化)	疾病和诊断
右侧髋骨	解剖部位
瘫痪	疾病和诊断
还原型谷胱甘肽	药物
输尿管	解剖部位
氨苯砜	药物
两膝退行性骨关节炎	疾病和诊断
食管胸中段癌	疾病和诊断
颈部+胸部，CT	影像检查
卵巢CA	疾病和诊断
乙状结肠切除	手术
I型呼吸衰竭	疾病和诊断
胸部	解剖部位
NE	实验室检验
颞支	解剖部位
心衰	疾病和诊断
上颌牙龈癌	疾病和诊断
上肢动脉PTA	手术
白蛋白	药物
左肺下叶原位腺癌	疾病和诊断
直肠壁	解剖部位
甲巯咪唑	药物
经皮肝穿胆道引流术	手术
达那唑胶囊	药物
右颈部至锁骨下	解剖部位
来曲唑	药物
泰素帝	药物
髂外淋巴	解剖部位
脑白质轻度脱髓鞘改变	疾病和诊断
吗丁啉	药物
输卵管造影	手术
两侧气管食管沟小淋巴结	解剖部位
横膈	解剖部位
右侧额部占位	疾病和诊断
结肠息肉	疾病和诊断
左肺门淋巴结转移	疾病和诊断
肝右内叶及左前叶下段占位性病变	疾病和诊断
闭塞症	疾病和诊断
食管恶性肿瘤ESD术后	疾病和诊断
乙状结肠癌切除+两侧附件占位切除	手术
胆石症术后	疾病和诊断
(左附件)卵巢腺癌	疾病和诊断
辛伐他汀	药物
急性肾功能衰竭	疾病和诊断
小弯	解剖部位
（胃）低分化粘液腺癌，溃疡型	疾病和诊断
汇管区小胆管	解剖部位
异丙托溴铵	药物
失血性休克	疾病和诊断
基底段	解剖部位
门腔间隙	解剖部位
鳞状细胞轻度增生并局灶高级别下皮内瘤变	疾病和诊断
子宫内膜病变术后	疾病和诊断
DIXON+结肠灌洗术	手术
直乙交界癌	疾病和诊断
空气灌肠整复术	手术
慢性心力衰竭	疾病和诊断
第一肝门右外叶	解剖部位
同型半胱氨酸	实验室检验
食管胃交界处溃疡型低分化腺癌	疾病和诊断
胃体癌	疾病和诊断
肝肿瘤微波消融术	手术
（直肠）中分化腺癌，溃疡型	疾病和诊断
左半结肠肿瘤	疾病和诊断
高敏肌钙蛋白T	实验室检验
鼻咽未分化型非角化行癌（T3N2M0）	疾病和诊断
尾骨	解剖部位
右侧肾下腺内侧肢	解剖部位
右卡尼汀	药物
肛肠	解剖部位
身	解剖部位
肝周	解剖部位
胃低分化腺癌	疾病和诊断
胃窦幽门管	解剖部位
胆道探查术后	疾病和诊断
内囊	解剖部位
返流性食管炎，残胃炎	疾病和诊断
急性胰腺炎	疾病和诊断
左上肺癌	疾病和诊断
肺内转移可能？	疾病和诊断
胆囊切除+胆总管切开取石+T管引流术	手术
前庭神经	解剖部位
颈胸部部CT	影像检查
左卵巢囊肿切除术	手术
超声引导上右肝肿块射频消融术	手术
食管裂孔	解剖部位
.腹膜后多发小淋巴	解剖部位
两侧髂总动脉	解剖部位
右肺底	解剖部位
肝右内叶	解剖部位
右肝内胆管细胞癌术后综合治疗后	疾病和诊断
卵巢癌切除	手术
胃癌术后腹腔转移	疾病和诊断
心脏	解剖部位
右乳内下	解剖部位
返流性食管炎	疾病和诊断
冷刀宫颈锥切术	手术
清宫术	手术
降结肠根治术	手术
白细胞数	实验室检验
根治性胃大部切除+毕I式吻合术	手术
左侧盆腔	解剖部位
上肢动脉粥样硬化闭塞症	疾病和诊断
部分管状腺癌	疾病和诊断
房颤	疾病和诊断
慢性结肠炎	疾病和诊断
AFLIBERCEPT	药物
亚胺培南	药物
厄贝沙坦氢氯噻嗪片	药物
T--PSA	实验室检验
慢性肺源性心脏病	疾病和诊断
血糖升高	疾病和诊断
肛门内外括约肌	解剖部位
十二指肠球部炎症	疾病和诊断
粒细胞缺乏	疾病和诊断
头	解剖部位
轻度贫血	疾病和诊断
腹腔动脉造影+栓塞术	手术
（直肠）腺癌（中度分化），隆起型	疾病和诊断
右侧颈动脉	解剖部位
糖尿病植物神经病变	疾病和诊断
慢性阻塞性肺疾病急性发作期	疾病和诊断
肝多发转移瘤	疾病和诊断
脑转移瘤	疾病和诊断
惠尔血	药物
非霍奇金淋巴瘤，，弥漫大B细胞型	疾病和诊断
阿卡波糖胶囊	药物
氟尿嘧啶	药物
尿蛋白	实验室检验
右室后壁	解剖部位
直肠癌切除术，分期T1N0M0	疾病和诊断
间接胆红素	实验室检验
肝占位	疾病和诊断
剖宫产术	手术
肌酐	实验室检验
脱髓鞘病变	疾病和诊断
结肠侧向发育型肿瘤（LST）	疾病和诊断
多系统萎缩	疾病和诊断
剖腹探查术+胃空肠吻合术	手术
金抗	药物
微绒毛	解剖部位
豉	药物
乙状结肠造瘘	手术
左髂外淋巴结	解剖部位
无创呼吸机辅助通气	手术
CF	药物
右肾下腺结节	疾病和诊断
CT检查	影像检查
食管中上段MT	疾病和诊断
十二指水平段	解剖部位
食管鳞状细胞癌（低分化）	疾病和诊断
肢体动脉	解剖部位
胆道术后肝内胆管结石	疾病和诊断
（右髂总）淋巴结	解剖部位
右锁骨下及左中颈淋巴结	解剖部位
PNET	疾病和诊断
伊马替尼	药物
B-II重建	手术
野马追糖浆	药物
吻合口狭窄	疾病和诊断
左肺上叶外基底段	解剖部位
右附件区	解剖部位
直肠息肉切除术	手术
大拇指	药物
胃隆起型高分化腺癌	疾病和诊断
宫颈低分化鳞状细胞癌，内生浸润型	疾病和诊断
肝内多发囊肿	疾病和诊断
胃癌根治术，毕II式远端胃	手术
CA72.4	实验室检验
缺血性心肌病型	疾病和诊断
右髂内	解剖部位
结肠全切除术后	疾病和诊断
原发性高血压3级很高危	疾病和诊断
胃癌根治术(全胃）	手术
肠溃疡型管状腺癌II级	疾病和诊断
十二指肠球部息肉伴柱状下皮化生	疾病和诊断
肝中叶	解剖部位
隆突	解剖部位
乙状结肠系膜	解剖部位
升结肠占位	疾病和诊断
肛管恶性肿瘤	疾病和诊断
TACE+肝动脉留管	手术
肝功能减退	疾病和诊断
肠镜息肉切除	手术
主动脉置换术	手术
右侧锁骨	解剖部位
右左骨盆漏斗	解剖部位
肠管	解剖部位
肝脏小囊肿	疾病和诊断
腹腔镜上横结肠切除手术	手术
胃癌伴腹腔种植转移	疾病和诊断
喉室	解剖部位
横结肠癌	疾病和诊断
右半结肠切除术术	手术
子宫肌瘤	疾病和诊断
自发性胰腺炎	疾病和诊断
左侧下颌窦及筛窦炎症	疾病和诊断
胆总管结石	疾病和诊断
前列腺增生	疾病和诊断
盲肠癌（，癌症分期为：T3N3M1）	疾病和诊断
主动脉弓	解剖部位
肝右外叶小肝癌	疾病和诊断
小肠癌	疾病和诊断
肠癌肝转移	疾病和诊断
薄芝糖肽	药物
胃术后	疾病和诊断
峡部	解剖部位
胃体溃疡型腺癌	疾病和诊断
直肠管状粘液腺癌（低分化），浸润溃疡型	疾病和诊断
结肠多发息肉镜上切除	手术
右髂部盆壁	解剖部位
先天性喉软骨发育不全	疾病和诊断
放射性食管炎	疾病和诊断
胸椎退行性改变	疾病和诊断
腹盆腔强化CT	影像检查
二尖瓣及三尖瓣重度反流	疾病和诊断
坎地沙坦	药物
肠粘连	手术
乙状结肠癌切除术、远端闭锁、近端造瘘术	手术
两侧附件	解剖部位
右心房	解剖部位
肠壁一站（3个）淋巴结	解剖部位
远端胃	解剖部位
泰素帝	药物
幽门下淋巴结	解剖部位
地塞米松	药物
肠系膜下动脉造影	手术
背部	解剖部位
高血压病（2级 很高危）	疾病和诊断
卵巢肿瘤	疾病和诊断
右髂髂外血管	解剖部位
肝左叶	解剖部位
肝动脉TACE术	手术
嗜铬细胞瘤	疾病和诊断
宫颈深肌层	解剖部位
酵母	药物
右侧髂内外血管旁淋巴结	解剖部位
全腹CT	影像检查
（左肝）肝细胞肝癌（II级）	疾病和诊断
结肠息肉内镜上切除	手术
右肺斜裂	解剖部位
盆腔内囊实性占位病变	疾病和诊断
右下颈	解剖部位
左侧卵巢囊性成熟性畸胎瘤	疾病和诊断
全腹增强CT	影像检查
左腹股沟	解剖部位
浸润性高分化鳞状细胞癌	疾病和诊断
扩大右半肝切除术	手术
结肠癌姑息切除术后	疾病和诊断
宫内孕不全流产	疾病和诊断
保留幽门的胰十二指肠切除术	手术
隆起型高中分化腺癌	疾病和诊断
肠系膜上动脉	解剖部位
骨关节	解剖部位
右心室	解剖部位
两肺门	解剖部位
阴茎	解剖部位
转移性癌	疾病和诊断
右闭孔淋巴结	解剖部位
肝脏左外叶切除	手术
肠镜上息肉切除术	手术
肝膈面	解剖部位
安定片	药物
肝左左叶肝内胆管	解剖部位
胸部切口	药物
胆石利通片	解剖部位
胆囊底部结节	疾病和诊断
基质	药物
(左半结肠)高中分化腺癌	疾病和诊断
快速性房颤	疾病和诊断
右肺转移灶手术	手术
结肠黑变病	疾病和诊断
右半结肠癌术后	疾病和诊断
（贲门）腺癌	疾病和诊断
肺炎	疾病和诊断
舌再造术	手术
中间淋巴结	解剖部位
左侧精索	解剖部位
肝门	解剖部位
奥曲肽	药物
双黄连	药物
唑来膦酸钠	药物
右、左宫	解剖部位
肝母细胞瘤	疾病和诊断
右侧肘部	解剖部位
下消化道钡餐	影像检查
结肠锯齿状腺瘤	疾病和诊断
右肾	解剖部位
回盲部肿瘤	疾病和诊断
糜烂性胃炎	疾病和诊断
腹部(CT平扫+增强)	影像检查
双侧肺门	解剖部位
双肺	解剖部位
舌咽	解剖部位
PAO2	实验室检验
降结肠末端	解剖部位
胰腺体部	解剖部位
直肠下段癌晚期，肝转移	疾病和诊断
胃小弯弥漫浸润性低分化腺癌	疾病和诊断
CA199 	实验室检验
两侧肾盂	解剖部位
腺苷	药物
碱性磷酸酶	实验室检验
(第7组）淋巴结	解剖部位
壶腹部鳞状细胞癌（低度分化）	疾病和诊断
房扑	疾病和诊断
卡替洛尔滴眼液	药物
压缩骨折	疾病和诊断
苯海索	药物
铁剂	药物
右上腹	解剖部位
TXT	药物
浸润性低分化鳞状细胞癌	疾病和诊断
腹腔穿刺术+闭式引流	手术
纵隔淋巴结	解剖部位
NSE 	实验室检验
浅表淋巴结	解剖部位
膀胱后方	解剖部位
卵巢切除	手术
胃体溃疡	疾病和诊断
开普拓	药物
胎盘多肽	药物
右上肢深静脉瓣膜	解剖部位
抑郁障碍	疾病和诊断
子宫双附件切除术	手术
比重	实验室检验
左乳癌术后	疾病和诊断
食管糜烂，非萎缩性胃炎	疾病和诊断
剖腹探查+肠粘连松解+左半结肠切除术	手术
肺转移	疾病和诊断
两侧肺	解剖部位
红枣	药物
输尿管镜检	手术
右下下腹部	解剖部位
SCC	实验室检验
(颈部食管旁)淋巴结	解剖部位
右室	解剖部位
整形	手术
纵隔镜纵隔淋巴结活检	手术
胃肠吻合口	解剖部位
盆腔B超	影像检查
椎体	解剖部位
梗阻性黄疸	疾病和诊断
左侧锁骨下窝淋巴结	解剖部位
直肠MILES术	手术
左侧大脑半球	解剖部位
安维汀	药物
浅表性胃炎	疾病和诊断
骨折内固定	手术
右侧卵巢	解剖部位
人工肝血浆置换术	手术
奥硝唑氯化钠	药物
下段食管	解剖部位
直肠乙状结肠	解剖部位
恩替卡韦	药物
腹腔镜DIXON+回肠造瘘术	手术
消化性溃疡	疾病和诊断
中央淋巴结	解剖部位
肠息肉	疾病和诊断
依那普利	药物
盆腹膜	解剖部位
根治术全胃切除术	手术
腹部增强MRI+MRCP	影像检查
左侧气管食管沟	解剖部位
多柔比星脂质体	药物
（左肝）肝脏原发性胆管细胞癌II级	疾病和诊断
酒精性脂肪肝	疾病和诊断
结肠多发憩室	疾病和诊断
胃癌伴幽门梗阻	疾病和诊断
胸壁肿物	疾病和诊断
幽门管	解剖部位
右髂血管淋巴结	解剖部位
肝曲结肠癌	疾病和诊断
直肠病损切除术	手术
（肝门部）淋巴结	解剖部位
上肢动脉置管溶栓术	手术
直肠HARTMANN手术	手术
颈部MRI	影像检查
脂肪乳	药物
食管溃疡型鳞状细胞癌II级	疾病和诊断
胃型粘膜	解剖部位
壶腹癌	疾病和诊断
右侧股动脉	解剖部位
腹主动脉旁、肠系膜区淋巴结，转移	疾病和诊断
盆腔囊性占位	疾病和诊断
腹会阴直肠癌根治术（MILES手术）	手术
ABO血型	实验室检验
右锁骨下淋巴结	解剖部位
“DIXON”术	手术
阿卡波糖	药物
腹盆腔	解剖部位
第8组淋巴结	解剖部位
右肾小囊肿	疾病和诊断
心	解剖部位
宫腔镜上子宫内膜息肉切除术	手术
胆囊穿刺造瘘术	手术
贲门溃疡型胃癌	疾病和诊断
胃体大弯侧溃疡型低分化腺癌	疾病和诊断
左肺门	解剖部位
亚胺培南	药物
食管占位	疾病和诊断
浆液性癌	疾病和诊断
胆总管上段	解剖部位
滑膜肉瘤	疾病和诊断
肝动脉旁淋巴结	解剖部位
活化部分凝血活酶比率	实验室检验
间质瘤	疾病和诊断
心包腔积液	疾病和诊断
胃全切除术后	疾病和诊断
(胃右动脉根部)淋巴结	解剖部位
左肩胛	解剖部位
分段诊刮	手术
头皮顶部转移	疾病和诊断
右侧输卵管粘膜	解剖部位
左半结肠切除+WIPPLE术	手术
心梗	疾病和诊断
左肺上叶原发腺癌术后	疾病和诊断
胃窦部大弯侧	解剖部位
动脉吻合术	手术
心电监护	影像检查
左侧大脑半球多发急性梗塞灶	疾病和诊断
肝左静脉	解剖部位
右结肠	解剖部位
宫颈癌IIA2期	疾病和诊断
瑞宁得	药物
右下肺舌段	解剖部位
肝硬化部分切除术后	疾病和诊断
中低分化腺癌伴印戒细胞癌，混合型	疾病和诊断
第5组淋巴结	解剖部位
二尖瓣置换术	手术
不完全性肠梗阻	疾病和诊断
浅表性胃体炎	疾病和诊断
盆腔CT	疾病和诊断
慢性肝病	疾病和诊断
胰腺	解剖部位
复方氨基酸注射液	药物
（结肠）腺癌（中度分化），浸润溃疡型	疾病和诊断
（胃）低分化腺癌	疾病和诊断
CRP	实验室检验
腹膜网膜肠系膜转移	疾病和诊断
胃慢性炎症伴HP感染	疾病和诊断
胃癌并肝转移	疾病和诊断
(肝左叶)腺癌	疾病和诊断
血小板减少	疾病和诊断
B细胞淋巴瘤	疾病和诊断
早期浸润	疾病和诊断
（贲门旁）淋巴结	解剖部位
吲哒帕胺	药物
右侧上肢动脉PTA+STENT术	手术
左手	解剖部位
宫体上段肌层	解剖部位
胃腔	解剖部位
右下肺前段	解剖部位
盆腔内	解剖部位
宫颈癌肉瘤	疾病和诊断
CA724	实验室检验
浅表性胃窦炎伴糜烂（III级）	疾病和诊断
胸中段食管	解剖部位
阑尾炎	疾病和诊断
脂肪囊	解剖部位
管状腺瘤1-2级	疾病和诊断
单硝酸异山梨酯	药物
直肠癌根治	手术
VI区最大淋巴结	解剖部位
（直肠）大肠隆起型管状腺癌II级	疾病和诊断
内镜上结肠息肉电切术	手术
胰腺被膜	解剖部位
体液免疫	药物
癌肉瘤	疾病和诊断
强力枇杷露	药物
(中间组）淋巴结	解剖部位
(上段食管旁)淋巴结	解剖部位
肠瘘	疾病和诊断
肝S4、S5/8	解剖部位
肺M	疾病和诊断
“肝细胞癌”切除术后	疾病和诊断
肝S5.8 交界区	解剖部位
（右盆腔）淋巴结	解剖部位
宫颈癌术后	疾病和诊断
PLT	实验室检验
乙状结肠低级别管状腺瘤	疾病和诊断
右半结肠根治性切除术	手术
心包	解剖部位
状下皮高级别下皮内瘤变	疾病和诊断
DIXONS’术式+回肠两腔造瘘术	手术
全麻上剖腹探查、左半结肠切除术	手术
胃早癌	疾病和诊断
部分肉瘤样癌	疾病和诊断
新型隐球菌	药物
胃肠间质肿瘤	疾病和诊断
十二指肠球部	解剖部位
臀	解剖部位
(直肠)溃疡型腺癌，分化III级	疾病和诊断
乙状结肠高分化腺癌	疾病和诊断
左髂血骨淋巴结	解剖部位
姜	药物
两肺上叶	解剖部位
脐	解剖部位
双侧喉返神经探查术	手术
两侧卵巢浆液性乳头状囊腺癌	疾病和诊断
胃底贲门	解剖部位
左侧胸腔	解剖部位
：胃印戒细胞	疾病和诊断
“DIXON'S”术	手术
氨肽素	药物
肠壁一站（10个）淋巴结	解剖部位
肝脏囊肿	疾病和诊断
两侧股动脉	解剖部位
卵巢癌分期术	手术
大网膜	解剖部位
气管切开术	手术
NDP	药物
远端闭锁，近端造瘘术	手术
TACE术	手术
卵巢癌肿瘤细胞减灭术+腹腔热灌注术	手术
腋中线	解剖部位
十二指肠球部息肉消融术	手术
表阿霉素	药物
西黄丸	药物
风湿性关节炎	疾病和诊断
美比达	药物
淋巴细胞绝对值	实验室检验
痰热清	药物
RhD血型	实验室检验
开腹根治性乙状结肠切除术	手术
盆腹CT	影像检查
日达仙	药物
氨酚双氢可待因片	药物
头颅MRI	影像检查
地塞米松乳膏	药物
胺碘酮	药物
降结肠	解剖部位
窦缓	疾病和诊断
食管低分化鳞状细胞癌	疾病和诊断
周皮	解剖部位
胸腔引流、胸腔冲洗	手术
甲硝唑	药物
胆囊息肉	疾病和诊断
糜烂性全胃炎	疾病和诊断
左肺门纵隔及锁骨下淋巴结转移	疾病和诊断
左侧腹	解剖部位
卵巢肿瘤切除	手术
神经内分泌分化	疾病和诊断
左半肝切除术+胆囊切除术	手术
支架置入术	手术
一站淋巴结	解剖部位
胃体上部大弯侧	解剖部位
介入术	手术
直肠癌术后吻合口瘘	疾病和诊断
颌上间隙	解剖部位
腘静脉血栓形成	疾病和诊断
血浆凝血酶原时间活动度	实验室检验
胰头	解剖部位
两侧胸膜	解剖部位
DXM	药物
两侧提肛肌	解剖部位
黏液腺癌	疾病和诊断
腹主动脉旁淋巴结	解剖部位
胸腹部	解剖部位
肾上腺色腙片	药物
BUN	实验室检验
肝肿瘤射频消融	手术
（肠系膜上动脉根部）淋巴结	解剖部位
囊性成熟性畸胎瘤	疾病和诊断
盆底	解剖部位
胃窦溃疡浸润型癌侵及胃角、幽门	疾病和诊断
重症急性胰腺炎	疾病和诊断
鳞癌	疾病和诊断
行胃癌根治术（远端胃大切）	手术
直肠隆起型管状腺癌	疾病和诊断
替硝唑	药物
肺动脉瓣及主动脉瓣轻度反流	疾病和诊断
肺癌根治术	手术
喉返神经	解剖部位
放置曼月乐环	手术
结肠周淋巴结	解剖部位
骶髂关节面	解剖部位
肺	解剖部位
N	实验室检验
腹腔镜DIXON	手术
实测碳酸氢根	实验室检验
膀胱癌根治术后	疾病和诊断
右颈根部	解剖部位
替考拉宁	药物
胆总管中分化腺癌	疾病和诊断
基底动脉钙化	疾病和诊断
核黄素	药物
结肠腺癌	疾病和诊断
横结肠两腔造瘘术+阴道修补术	手术
两侧筛窦及额窦炎	疾病和诊断
直肠粘膜黑色素瘤合并印戒细胞癌	疾病和诊断
宫颈癌IIA1期	疾病和诊断
室间隔增厚	疾病和诊断
ERCP+胆管支架植入术	手术
子宫峡	解剖部位
直肠癌术后，回肠造瘘术后	疾病和诊断
CA 199	实验室检验
直肠~结肠癌	疾病和诊断
门静脉左干	解剖部位
弥漫大B细胞淋巴瘤回盲部切除术后	疾病和诊断
肝肿瘤切除术	手术
两侧输卵管结扎术	手术
腹主动假性动脉瘤	疾病和诊断
升结肠腺癌腹腔多发种植，伴不完全肠梗阻	疾病和诊断
中上段直肠癌	疾病和诊断
宫颈低分化癌	疾病和诊断
腹腔镜上直肠癌根治术+预防性回肠造瘘	手术
肌钙蛋白	实验室检验
萎缩性胃窦炎	疾病和诊断
结肠癌肝转移术后	疾病和诊断
轻度慢性发炎	疾病和诊断
直肠癌左上肺转移	疾病和诊断
AFP	实验室检验
肩部	解剖部位
淀粉	药物
低白蛋白血症	疾病和诊断
（胃窦）慢性萎缩性胃炎（中度）	疾病和诊断
肝细胞性肝癌伴胆管癌栓	疾病和诊断
门冬氨酸氨基转移酶 	实验室检验
心包积液并心包增厚	疾病和诊断
重组甘精胰岛素注射液（长秀霖笔芯）	药物
卵巢恶性肿瘤	疾病和诊断
腹盆腔，CT	影像检查
完全性右束支传导阻滞	疾病和诊断
气管插管	手术
乙状结肠癌切除、肝部分切除	手术
R-GT	实验室检验
7、8、9组&GT;淋巴结	解剖部位
右乳癌改良根治术	手术
管状腺癌II级	疾病和诊断
高分化腺癌	疾病和诊断
胸，CT	影像检查
康士德	药物
肺部	解剖部位
类克	药物
肺动脉	解剖部位
腰骶部平扫	影像检查
中分化鳞状细胞癌	疾病和诊断
丙酸睾酮	药物
（第一组）淋巴结	解剖部位
单硝酸异山梨酯	药物
心脏CT	影像检查
(直肠)腺癌(高-中分化)	疾病和诊断
胆总管中段狭窄	疾病和诊断
肠系膜肿瘤切除术	手术
宫颈浸润型鳞状细胞癌II级	疾病和诊断
肝门部胆管癌根治术	手术
十二指肠癌术后	疾病和诊断
（直肠），：直肠溃疡型黏液腺癌	疾病和诊断
肾出血	疾病和诊断
Na	实验室检验
左肾输尿管全长切除	手术
药敏	实验室检验
冠心病	疾病和诊断
肝介入治疗（TAI）	手术
胸骨	解剖部位
胃癌伴腹腔盆腔转移	疾病和诊断
左锁骨下淋巴结转移癌	疾病和诊断
乙状结肠息肉	疾病和诊断
结肠CA	疾病和诊断
吡柔比星膀胱灌注	手术
尿糖	实验室检验
心脏血管及主动脉钙化	疾病和诊断
腹膜后小淋巴结	解剖部位
胃窦腺癌（中低度分化）	疾病和诊断
腹腔镜上直肠癌姑息性切除术DIXON	手术
手	解剖部位
直肠癌根治术后	疾病和诊断
肛周	解剖部位
环酯红霉素	药物
子宫右前侧壁上段	解剖部位
升结肠）管状腺瘤，I级	疾病和诊断
眼角膜	解剖部位
胆囊穿刺置管引流术	手术
阴阳五行散	药物
单纯性肥胖	疾病和诊断
经腹食管胃交界腺癌根治术	手术
大肠溃疡型粘液腺癌	疾病和诊断
横结肠癌腹腔多发转移瘤	疾病和诊断
善存	药物
阑尾及小肠粘膜慢性炎	疾病和诊断
直乙交界处结肠癌	疾病和诊断
左侧腓动脉	解剖部位
右梨状肌	解剖部位
FU	药物
左腹股沟淋巴结	解剖部位
网膜	解剖部位
开腹子宫内膜癌分期手术+大网膜切除术	手术
EGJ中低分化腺癌伴印戒细胞癌，混合型	疾病和诊断
食管炎伴糜烂	疾病和诊断
慢性阻塞性肺病急性加重	疾病和诊断
胃区	解剖部位
疝	疾病和诊断
数字胃肠造影	影像检查
冻干人纤维蛋白原	药物
结肠肝曲癌	疾病和诊断
肝样腺癌	疾病和诊断
腹膜返折	解剖部位
PH	实验室检验
闭孔	解剖部位
胸椎骨质增生	疾病和诊断
腹腔镜上胃体间质瘤切除术	手术
贲门右淋巴结	解剖部位
左侧口口咽部）非角化型鳞状细胞癌	疾病和诊断
左肾母细胞瘤 IIIB期	疾病和诊断
宫肌瘤剥除术	手术
心包区	解剖部位
胃窦部与胰腺之间淋巴结	解剖部位
直肠吻合口口瘘	疾病和诊断
周身骨骼	解剖部位
“胃癌术	疾病和诊断
剖腹探查+小肠粘连松解术	手术
乳腺病伴导管内乳头状	疾病和诊断
升结肠	解剖部位
骶	解剖部位
肝功能不全	疾病和诊断
头孢哌酮钠	药物
腹腔镜	手术
中分化肝细胞性肝癌	疾病和诊断
NVB	药物
腹泻	疾病和诊断
小腿前部	解剖部位
胃管	解剖部位
上肢静脉造影	影像检查
血脂代谢异常	疾病和诊断
胃体下段至胃底贲门部	解剖部位
(乙状)结肠蕈伞型管状腺癌II级	疾病和诊断
心功能Ⅲ-Ⅳ级	疾病和诊断
碘化油	药物
鳞癌（中分化）	疾病和诊断
颈部	解剖部位
LDH	实验室检验
上腹	解剖部位
胃第六组”（1/1）淋巴结	解剖部位
右侧腋窝肿块切除术	手术
舌头	解剖部位
升结肠肠管	解剖部位
硝酸异山梨酯	药物
HB	实验室检验
直肠系膜	解剖部位
贲门大弯侧后壁	解剖部位
直肠癌DIXON手术	手术
幽门螺旋杆菌抗体	实验室检验
直肠癌根治术（DIXON	手术
腹腔镜直肠癌根治	手术
胃窦癌伴出血伴肝脏、胰腺受侵	疾病和诊断
盐酸吉西他滨	药物
肌瘤挖除术	手术
肋骨骨折	疾病和诊断
食管上端	解剖部位
（腹主动脉旁）淋巴结	解剖部位
右锁下	解剖部位
出血性胃炎	疾病和诊断
胃黏膜	解剖部位
胆囊多发小结石	疾病和诊断
吻合口瘘	疾病和诊断
肠周纤维脂肪	解剖部位
右侧颈内动脉	解剖部位
比卡鲁胺片	药物
右锁下下淋巴结	解剖部位
易蒙停	药物
输卵管壶腹部	解剖部位
腹腔镜上左半结肠姑息性切除术	手术
脾曲结肠癌	疾病和诊断
血小板	疾病和诊断
腹腔穿刺	手术
氯硝安定	药物
造口旁疝	疾病和诊断
TAE	手术
食管胃交界部腺癌	疾病和诊断
关节清理	手术
肝RFA	手术
肝肿瘤切除+胆囊切除术	手术
颈动脉粥样硬化	疾病和诊断
浸润性高级别尿路下皮癌	疾病和诊断
腹部	解剖部位
髂骨翼	解剖部位
两侧附件区	解剖部位
十二指肠球部炎性息肉	疾病和诊断
尿素氮	实验室检验
腰1压缩性骨折	疾病和诊断
结肠旁沟	解剖部位
胃癌术后脑转移 RTXNXM1 IV期	疾病和诊断
脾血管	解剖部位
5、8、12组淋巴结	解剖部位
总胆红素	实验室检验
右颈部V区	解剖部位
回肠造瘘	手术
肺叶切除术	手术
原发性高血压3级 很高危	疾病和诊断
前降支狭窄20-50%	疾病和诊断
系膜根部淋巴结	解剖部位
特尔津	药物
完全性左束支传导阻滞	疾病和诊断
氯丙咪嗪片	药物
锁骨下B超	影像检查
葡醛内酯片	药物
肝门部胆管癌	疾病和诊断
浸润性腺癌	疾病和诊断
第四脑室	解剖部位
乳酸脱氢酶	实验室检验
上肢深静脉彩超	影像检查
支气管扩张	疾病和诊断
血沉增快	疾病和诊断
食管胃交界区癌	疾病和诊断
胆总管切开探查	手术
胃癌根治术（近端胃大切，食管胃吻合）	手术
左上肢	解剖部位
腹腔镜上右半结肠切除术	手术
氨茶碱	药物
胃造瘘术	手术
腹腔镜上扩大根治性左半结肠癌切除	手术
虑胃	影像检查
右肺门	解剖部位
结肠癌	疾病和诊断
术后切口感染	疾病和诊断
中央型前置胎盘	疾病和诊断
上皮增生	疾病和诊断
水肿待查	疾病和诊断
贲门肿物	疾病和诊断
两卵巢	解剖部位
糖尿病糖尿病酮症酸中毒	疾病和诊断
溃疡性直肠炎	疾病和诊断
喹诺酮	药物
肝转移	疾病和诊断
心房纤颤伴II°房室传导阻滞	疾病和诊断
宫颈癌IIB期	疾病和诊断
利培酮	药物
气管切开	手术
直肠腺癌（中、低度分化）,隆起型	疾病和诊断
胃	解剖部位
胃窦炎	疾病和诊断
空肠端侧吻合	手术
肝切缘	解剖部位
中低分化腺癌部分印戒，混合型	疾病和诊断
腰	解剖部位
子宫腺肌病	疾病和诊断
纤维蛋白原	实验室检验
型预激综合征	疾病和诊断
肛	解剖部位
内镜上直肠息肉切除术	手术
奥施康定	药物
交叉韧带重建术	手术
右半结肠溃疡型中低分化腺癌伴粘液腺癌	疾病和诊断
下腹部MRI	影像检查
钙片	药物
肠壁浆膜上层	解剖部位
培美曲赛	药物
全子宫双附件切	手术
（下段食管旁）淋巴结	解剖部位
胃粘膜	解剖部位
头孢唑肟	药物
腹左胸食管癌切除术	手术
胆道造影	影像检查
埃索美拉唑肠溶胶囊	药物
胃窦后壁	解剖部位
肩背部	解剖部位
肺门淋巴结	解剖部位
肝血管造影	影像检查
低级别鳞状下皮内病变	疾病和诊断
溃疡性结肠炎	疾病和诊断
PET-CT	影像检查
内痔	疾病和诊断
混合性下皮肿瘤(低恶性)	疾病和诊断
右上肢静脉	解剖部位
左肺下叶尖段	解剖部位
十二指肠降部SMT	疾病和诊断
十二指肠降段口粘膜隆起待查	疾病和诊断
美沙拉嗪	药物
食管浅溃疡	疾病和诊断
平均红细胞体积	实验室检验
奥先达	药物
宫颈息肉切除	手术
痔疮手术	手术
淋巴结转移	疾病和诊断
TACE	手术
第12A组淋巴结	解剖部位
贲门癌根治	手术
左乳	解剖部位
肠管系膜	解剖部位
子宫肌瘤良性病变	疾病和诊断
中间组（1个）淋巴结	解剖部位
替吉奥胶囊	药物
腹腔镜辅助上乙状结肠癌根治术	手术
隆突上	解剖部位
霉菌性食管炎	疾病和诊断
前列腺癌	疾病和诊断
（第11组）淋巴结	解剖部位
胸腔感染	疾病和诊断
血糖	实验室检验
罗格列酮	药物
右髂血管	解剖部位
腹壁切口清创缝合术	手术
腹部	解剖部位
中性粒细胞绝对值	实验室检验
髂耻	解剖部位
右侧股股浅动脉闭塞旁路术	手术
胃窦大弯侧腺癌（中度分化），浸润溃疡型	疾病和诊断
脓性	疾病和诊断
右侧上肢	解剖部位
血管造影	影像检查
胃体小弯侧溃疡型低分化腺癌	疾病和诊断
2型糖尿病	疾病和诊断
膈动脉	解剖部位
双侧肾脏	解剖部位
安神	药物
支气管哮喘	疾病和诊断
右前臂动静脉内瘘吻合术	手术
中效胰岛素	药物
左大隐静脉曲张术后	疾病和诊断
两肾下腺	解剖部位
乙状结肠隆起型中分化腺癌	疾病和诊断
直肠肿物切除术	手术
胃肠道	解剖部位
胃窦	解剖部位
甲状腺癌转移	疾病和诊断
切面	解剖部位
隆起型中分化腺癌	疾病和诊断
乙状结肠溃疡型高中分化腺癌伴粘液分泌	疾病和诊断
高级别下皮内瘤变	疾病和诊断
胃多发息肉切除术	手术
肺占位	疾病和诊断
剖腹探查术+回肠造瘘术	手术
肌瘤电切	手术
肌张力障碍	疾病和诊断
全身，PET-CT	影像检查
腹腔镜上广泛子宫切除	手术
大青叶	药物
（第4SB组）淋巴结	解剖部位
左侧盆腔淋巴结	解剖部位
腹腔镜胃癌根治术	手术
左肝占位	疾病和诊断
海绵窦	解剖部位
右耳垂	解剖部位
停搏	疾病和诊断
两肾小结石或钙化	疾病和诊断
双侧胸腔积液	疾病和诊断
右左宫旁	解剖部位
轻度慢性萎缩性胃炎	疾病和诊断
肠壁转移瘤	疾病和诊断
胸腔闭式引流术	手术
拜阿司匹林	药物
肠中至低分化腺癌，部分为粘液腺癌	疾病和诊断
食管裂孔疝	疾病和诊断
升结肠腺癌破裂穿孔致急性弥漫性腹膜炎	疾病和诊断
乙状结肠MT	疾病和诊断
第7组）淋巴结	解剖部位
纵膈淋巴结	疾病和诊断
消化道造影	影像检查
腰椎及骨盆骨转移	疾病和诊断
腹CT	影像检查
系膜区域淋巴结	解剖部位
消炎利胆片	药物
（右侧腹股沟）淋巴结	解剖部位
甲状腺	解剖部位
降结肠病变	疾病和诊断
结膜结石	疾病和诊断
根治性胃大部切除、毕I式吻合术	手术
右中上腹小肠	解剖部位
贲门小弯侧	解剖部位
经胃镜上营养管置入术	手术
肝右叶	解剖部位
高至中分化鳞状细胞癌	疾病和诊断
浸润性中分化腺癌	疾病和诊断
中度慢性浅表性胃炎	疾病和诊断
胸部正位片	影像检查
左半结肠切除+开腹恶性肿瘤特殊治疗	手术
坦索罗辛	药物
结肠癌根治术	手术
右侧颞、枕叶慢性脑梗死	疾病和诊断
倍他乐克	药物
右侧胸腔	解剖部位
顶叶	解剖部位
急性呼吸衰竭	疾病和诊断
腹部超声	影像检查
扩大左半结肠切除术	手术
口咽	解剖部位
胸部ＣＴ	影像检查
子宫内膜腺癌I级	疾病和诊断
姑息性乙状结肠癌切除+横结肠造瘘术	手术
腰2/3、3/4、4/5椎间盘突出	疾病和诊断
HFS	疾病和诊断
慢性丙型肝炎	疾病和诊断
盆腔包块	解剖部位
贲门周淋巴结	解剖部位
食管上段鳞癌术后	疾病和诊断
肝转移瘤切除	手术
房颤伴快速心室率	疾病和诊断
丹参川芎嗪	药物
盆腔中低分化腺癌	疾病和诊断
胃角MT	疾病和诊断
改良根治术	手术
慢性阻塞性肺疾病	疾病和诊断
横结肠	解剖部位
两肺炎症伴纤维灶	疾病和诊断
阑尾慢性炎	疾病和诊断
主动脉梭	解剖部位
恶性黑色素瘤	疾病和诊断
左侧股动脉穿刺	手术
半卵圆中心	解剖部位
两侧髂	解剖部位
（左半结肠）结肠隆起型高中分化腺癌	疾病和诊断
左乳腺癌	疾病和诊断
左侧颈部淋巴结	解剖部位
（第3组）淋巴结	解剖部位
西沙必利	药物
食管中段早癌、贲门癌	疾病和诊断
肝癌术后	疾病和诊断
胸腰椎	解剖部位
疱疹病毒感染	疾病和诊断
左中腹部肠系膜间	解剖部位
血小板	实验室检验
MRI	实验室检验
两上肢CTA	影像检查
左冠近中段	解剖部位
低分化癌转移	疾病和诊断
手足综合征	疾病和诊断
（远端）腹腔镜辅助胃癌根治术	手术
原发性肝癌粒子植入术	手术
DEX	药物
胸腹MR	影像检查
美托洛尔缓释片	药物
腹腔镜下盆腔粘连分解术	手术
胃体	疾病和诊断
腺肿	疾病和诊断
左上肢截肢手术	手术
心痛定	药物
肠中分化腺癌	疾病和诊断
肠扭转复位术	手术
胸下段食管鳞癌	疾病和诊断
左肺下叶后段	解剖部位
食管胃交界腺癌	疾病和诊断
中上腹	解剖部位
盆腔积液	疾病和诊断
内镜上切除术	手术
腹腔镜DIXON+开腹肝转移瘤切除术	手术
卵泡	解剖部位
第1组淋巴结	解剖部位
甲状腺原发恶性肿瘤并淋巴结转移	疾病和诊断
袖状胃切除术后	疾病和诊断
肠梗阻？	疾病和诊断
RFA	手术
胆囊管结石	疾病和诊断
塞维健	药物
右侧输尿管扩张	疾病和诊断
两侧盆腔淋巴结	解剖部位
直肠前壁	解剖部位
筛状粉刺型腺癌	疾病和诊断
血沉	实验室检验
胃癌根治术（胃全切）	手术
型子宫切除	手术
左侧丘脑	解剖部位
右上肺	解剖部位
糜烂性胃炎（II级）	疾病和诊断
吻合口	解剖部位
胃癌术后复发	疾病和诊断
右侧胸腔穿刺	手术
绒毛状腺瘤	疾病和诊断
颈肌	解剖部位
两肺上叶钙化灶	疾病和诊断
MCH	实验室检验
低分化管状腺癌	疾病和诊断
酸碱度	实验室检验
左乳腺癌根治	手术
浅表萎缩性胃炎	疾病和诊断
新生物	药物
沙美特罗	药物
左心房	解剖部位
室壁	解剖部位
结肠息肉电切术	手术
肝囊肿开窗引流	手术
宫腔镜上子宫粘膜上肿物切除术	手术
（宫腔）子宫内膜样腺癌，G2	疾病和诊断
左侧乳腺癌改良根治术	手术
左肝部分切除、胆囊切除术	手术
右锁骨下动脉	解剖部位
关节止痛膏	药物
贲门肿瘤可能？	疾病和诊断
胃癌并发转移	疾病和诊断
脐部	解剖部位
腺癌	解剖部位
眼睑下垂	疾病和诊断
左肺下叶、中叶及两上肺感染	疾病和诊断
乙状结肠术后	疾病和诊断
T2	解剖部位
直肠癌根治术（DIXON式）	手术
腹腔镜宫颈癌根治术	手术
系膜	解剖部位
结肠溃疡型中高分化腺癌，部分粘液腺癌	疾病和诊断
腹壁	解剖部位
开塞露	药物
右足第1、2趾远端	解剖部位
铝碳酸镁片	药物
食管中上段鳞癌	疾病和诊断
侧脑室	解剖部位
乳腺区段切除术	手术
葡萄糖注射液	药物
血小板数	实验室检验
宫颈锥切术	手术
子宫颈颈管内口	解剖部位
右髂内	解剖部位
横结肠癌术后	疾病和诊断
上臂	解剖部位
根治性远端胃大部切除术	手术
RFA术	手术
山楂	药物
细胞角蛋白	药物
右卵巢囊肿	疾病和诊断
心力衰竭	疾病和诊断
尿毒清颗粒	药物
慢性非萎缩性胃炎伴糜烂	疾病和诊断
卵巢癌	疾病和诊断
瑞舒伐他汀	药物
胃癌	疾病和诊断
消化道溃疡	疾病和诊断
食管癌放化疗后复发	疾病和诊断
鼻咽恶性肿瘤	疾病和诊断
右侧肩胛骨转移	疾病和诊断
（第十一组）淋巴结	解剖部位
康士得	药物
横结肠中段偏左	解剖部位
指间关节	解剖部位
肝S8肿瘤	疾病和诊断
细胞淋巴瘤	疾病和诊断
两肺上叶少许感染	疾病和诊断
腹腔镜辅助上姑息性全胃切除术（D2）	手术
肝门区，胃右动脉旁淋巴结转移	疾病和诊断
脾脏切除术后	疾病和诊断
转移性淋巴癌	疾病和诊断
结肠下动脉根部	解剖部位
回肠末端（穿孔部分）切除端侧吻合术	手术
贲门右小淋巴结	解剖部位
右侧闭孔淋巴结	解剖部位
肝左叶切除术+胆囊切除术	手术
颅	解剖部位
结肠癌并腹腔淋巴结转移	疾病和诊断
银黄含片	药物
结肠中动、静脉	解剖部位
（结肠大体）镜检为中分化腺癌	疾病和诊断
OR	影像检查
胃癌、胃空肠吻合术后	疾病和诊断
辰易	药物
门齿	解剖部位
（肠系膜上血管旁）淋巴结	解剖部位
十二指肠韧带	解剖部位
肺部感染	疾病和诊断
(结肠中动脉根部）淋巴结	解剖部位
舌面	药物
肩臂	解剖部位
宫颈及颈管	解剖部位
直肠下动脉旁淋巴结	解剖部位
直肠癌多发转移化疗后	疾病和诊断
升结肠近肝曲	解剖部位
胃低分化腺癌术后	疾病和诊断
三七	药物
MRCP	影像检查
肿物周淋巴结	解剖部位
肝脓肿	疾病和诊断
C肽（2H）	实验室检验
胃角溃疡	疾病和诊断
（肝十二指肠韧带）淋巴结	解剖部位
胃溃疡型低分化管状腺癌	疾病和诊断
左卵巢瘤	疾病和诊断
食道上返流性炎症	疾病和诊断
冠状动脉粥样硬化性心脏病	疾病和诊断
甘油灌肠剂	药物
中低分化腺癌	疾病和诊断
肝右内叶至肝左叶交界处	解剖部位
肠低分化腺癌（印戒细胞癌）	疾病和诊断
前交通动脉瘤栓塞术	手术
股神经	解剖部位
左小腿	解剖部位
乙状结肠腺瘤	疾病和诊断
乳浸润性导管癌	疾病和诊断
胃印戒细胞癌	疾病和诊断
PETCT	影像检查
十二指肠腹壶	解剖部位
里葆多	药物
小脑半球	解剖部位
横结肠增生性腺瘤性息肉	疾病和诊断
多脏器功能衰竭	疾病和诊断
十二指肠-胃窦部	解剖部位
肝多发小囊肿	疾病和诊断
右侧附件切	手术
髂总动脉	解剖部位
DIXON术	手术
主动脉旁淋巴结	解剖部位
头痛粉	药物
子宫切除术及右侧附件切除术	疾病和诊断
食管	解剖部位
乳腺切除	手术
胃小弯淋巴结	解剖部位
腹腔镜上直肠部分切除术	手术
直肠下动脉旁染色淋巴结2	解剖部位
凝血酶时间	实验室检验
MR	影像检查
全子宫+两附件切除+腹盆腔粘连松解术	手术
胃第八组淋巴结	解剖部位
特发性震颤	疾病和诊断
腹腔大量积液	疾病和诊断
肝尾	解剖部位
膀胱肿瘤复发	疾病和诊断
膀胱浸润性癌	疾病和诊断
阿司匹林肠溶片	药物
珍菊降压片	药物
神经组织	解剖部位
（胃窦、幽门）腺癌	疾病和诊断
胃癌手术	手术
左颈根至锁骨下淋巴结	解剖部位
左附件区	解剖部位
左侧附件	解剖部位
MRI检查	影像检查
肩胛	解剖部位
食道癌术后	疾病和诊断
会阴部	解剖部位
内膜组织	解剖部位
结肠直肠多发性息肉	疾病和诊断
大肠管状腺瘤	疾病和诊断
APTT	实验室检验
西地兰	药物
食管胃交界	解剖部位
非那雄胺	药物
（第11P组）淋巴结	解剖部位
腹腔少量积液	疾病和诊断
跌伤	疾病和诊断
右锁骨下区、纵隔、左肺门淋巴结	解剖部位
妥泰	药物
子宫上段	解剖部位
LYMPH	实验室检验
他莫昔芬	药物
肝活检术	手术
胃大弯后壁	解剖部位
肠系膜上静脉血栓形成伴肠坏死	疾病和诊断
腹部血管DSA	影像检查
直肠子宫陷凹	解剖部位
头孢唑肟钠	药物
壶腹周围癌	疾病和诊断
尿培养	实验室检验
右附件	解剖部位
右、左卵巢	解剖部位
骨髓异常增生	疾病和诊断
右侧髂静脉球囊扩张成形术	手术
CEA 30	实验室检验
发热待查	疾病和诊断
脑动脉瘤	疾病和诊断
急性单纯性阑尾炎	疾病和诊断
肝右叶	解剖部位
膀胱癌	疾病和诊断
左肝管	解剖部位
两肾小囊肿	疾病和诊断
腹腔镜下乙状结肠切除术	手术
神经内分泌癌	疾病和诊断
洛铂	药物
下段输尿管	解剖部位
（第12P组）淋巴结	解剖部位
肝癌切除术	手术
核酸检测	实验室检验
升结肠恶性肿瘤术后	疾病和诊断
丙氨酸氨基转移酶	实验室检验
全身骨显像+，骨断层显像	影像检查
右侧输尿管	解剖部位
哈乐	药物
豆状核	解剖部位
经皮气管切开术	手术
Hb	实验室检验
门静脉	解剖部位
直肠炎	疾病和诊断
SMT	疾病和诊断
动脉	解剖部位
一站淋巴结	解剖部位
氧饱和度	实验室检验
消化道	解剖部位
神经节细胞	解剖部位
结肠癌伴肝转移	疾病和诊断
左叶肝细胞性肝癌，中分化	疾病和诊断
弓上吻合	手术
右侧腹直肌	解剖部位
漏出液	解剖部位
左室	解剖部位
肝内多发转移	疾病和诊断
腓动脉	解剖部位
麻仁胶囊	药物
左室肥大	疾病和诊断
结节性甲状腺肿	疾病和诊断
(中段食管旁）淋巴结	解剖部位
岛叶	解剖部位
宫颈癌IB1期	疾病和诊断
下腔静脉滤器置入术	手术
腹盆部CT	影像检查
颌下腺切除	手术
心包穿刺	手术
腹部立位平片	影像检查
右侧基底节区	解剖部位
鳞状细胞原位癌	疾病和诊断
TAMOXIFEN	药物
阴道肿物	疾病和诊断
顶叶	解剖部位
胃窦小弯腺癌（中度分化）	疾病和诊断
动脉硬化伴多发斑块形成	疾病和诊断
糖尿病糖尿病性肾病	疾病和诊断
胆囊切除术后	疾病和诊断
胚胎结构	解剖部位
肝胃间隙	解剖部位
双侧扁桃体切除术	手术
右乳转移	疾病和诊断
搐搦	疾病和诊断
PaCO2	实验室检验
胃大小弯淋巴结	解剖部位
胸上段上段食管	解剖部位
白细胞总数 	实验室检验
上段食管	解剖部位
腹膜弥漫转移	疾病和诊断
中分化腺癌	疾病和诊断
AECOPD	疾病和诊断
右肺上叶切除	手术
替普瑞酮胶囊	药物
宫颈鳞状细胞原位癌累及腺体	疾病和诊断
胃早癌剥离术	手术
肝尾叶部分切除	手术
骶3下缘	解剖部位
眼睑	解剖部位
胰腺囊腺癌	疾病和诊断
哌拉西林钠他唑巴坦钠	药物
溃疡型中分化管状腺癌（T3N0M0）	疾病和诊断
谷氨酰胺	药物
结肠肝曲管状腺癌	疾病和诊断
食管上段贲门CA	疾病和诊断
直肠（切除）浸润性中分化腺癌	疾病和诊断
尿失禁	疾病和诊断
锁骨下窝	解剖部位
上腔静脉滤器置入、两侧髂静脉支架置入	手术
右侧腘静脉血栓形成（急性期）	疾病和诊断
胆囊癌肝转移	疾病和诊断
成型术	手术
支架植入术	手术
肝脏MRI	影像检查
两侧髂血管	解剖部位
氯	实验室检验
（结肠中动脉根部）淋巴结	解剖部位
左肺周围型肺癌	疾病和诊断
NEUT	实验室检验
血小板减少性紫癜	疾病和诊断
网膜淋巴结	解剖部位
左侧卵巢	解剖部位
肱骨干	解剖部位
病灶切除术	手术
两侧卵巢切除术	手术
胆红素	实验室检验
贝林	药物
假性动脉瘤	疾病和诊断
碳酸氢根	实验室检验
肝顶	解剖部位
肠癌根治术	手术
腹腔镜上横结肠癌根治性切除术	手术
解剖性右半肝切除+胆囊切除术	手术
下腹部，CT	影像检查
肝左叶部分切除术	手术
腹主动脉旁	解剖部位
髂总淋巴	解剖部位
前列腺增生症，伴PINI级	疾病和诊断
清创缝合术	手术
胃体小弯溃疡	疾病和诊断
肝转移瘤射频消融术	手术
左颈部	解剖部位
左肾囊肿去顶术	手术
全胃低分化腺癌	疾病和诊断
血管瘤	疾病和诊断
胃底腺息肉	疾病和诊断
纵隔及左肺门区淋巴结钙化	疾病和诊断
腹主动脉右旁淋巴结	解剖部位
胃底贲门-小弯侧恶性肿瘤	疾病和诊断
直肠高分化腺癌	疾病和诊断
泰诺	药物
骨质疏松症	疾病和诊断
左侧阔韧带	解剖部位
盆腔彩超	影像检查
全子宫切除术+右侧附件切除术	手术
两上肢动脉硬化伴粥样斑点	疾病和诊断
结肠、直肠多发性息肉	疾病和诊断
奥司他韦	药物
法玛新	药物
乐沙定	药物
主动脉瓣	解剖部位
直肠癌低位前切除术+预防性回肠造瘘术	手术
肝S2囊肿	疾病和诊断
乳头	解剖部位
右肾输尿管中段结石伴右肾积水（中度）	疾病和诊断
小弯侧淋巴结	解剖部位
胃癌伴腹腔多发转移	疾病和诊断
善龙	药物
基线CT	影像检查
MRI	影像检查
L5椎体	解剖部位
慢性肾脏病（CKD3期）	疾病和诊断
胆囊切除、左半肝切除术	手术
胃底间质瘤	疾病和诊断
肝左叶上段	解剖部位
左侧髂总髂外	解剖部位
HCT	实验室检验
顶区	解剖部位
宫腔镜下子宫肌瘤电切术	手术
右侧髂骨多发骨质破坏	疾病和诊断
贲门右淋巴结	解剖部位
右季肋区	解剖部位
胃体大弯侧	解剖部位
两肺多发转移瘤	疾病和诊断
功能性淋巴结清扫术	手术
右肾切除术	手术
食道胸中段鳞癌	疾病和诊断
上腹正中	解剖部位
肠壁	解剖部位
内膜异位症	疾病和诊断
脑苷肌肽	药物
高级别鳞状上皮内病变	疾病和诊断
结肠中血管右支根部淋巴结	解剖部位
喉头	解剖部位
经左胸下腹部分食管切除术+胃食管吻合术	手术
氨基酸	药物
AST 	实验室检验
胃体小弯腺癌（中度分化）	疾病和诊断
频发室早？	疾病和诊断
两侧基底节区腔隙性脑梗死	疾病和诊断
氟伐他汀钠缓释片	药物
贝敏伪麻	药物
胆肠肠吻合口处梗阻	疾病和诊断
左侧足第3趾趾离断术+VSD置入术	手术
两颈部	解剖部位
内镜上胃多发息肉切除	手术
腹B超	影像检查
膀胱子宫陷凹	解剖部位
右肾囊肿	疾病和诊断
右腹	解剖部位
右肩部	解剖部位
宫颈下唇	解剖部位
普美显	药物
氨磷汀	药物
直肠癌伴肝转移	疾病和诊断
S2、3	解剖部位
腰椎	解剖部位
CEA 	实验室检验
哌拉西林他坐巴坦	药物
进展期胃癌，隆起型，高-中分化管状腺癌	疾病和诊断
结肠	解剖部位
脾静脉	解剖部位
动脉夹层	解剖部位
胃体前壁偏小弯侧	解剖部位
肠粘连松解术+空肠造瘘术	手术
（食管）鳞状下皮呈重度不典型增生	疾病和诊断
腹部立位片	影像检查
肝脏S2、S7/8	解剖部位
新生儿贫血	疾病和诊断
盲肠腺癌	疾病和诊断
升结肠肠周	解剖部位
北华素	药物
阿卡波糖片	药物
胸腔镜上左肺转移切除术	手术
直肠癌切除术	手术
区淋巴结清扫术	手术
胃体	解剖部位
左肾囊肿	疾病和诊断
直肠息肉切除术	手术
气道	解剖部位
卵巢癌术后	疾病和诊断
颅脑出血	疾病和诊断
二甲两胍	药物
TBIL	实验室检验
不孕症	疾病和诊断
浅表性胃窦炎伴糜烂	疾病和诊断
上腹部CT	影像检查
胃体癌慢性萎缩性胃炎	疾病和诊断
阑尾浆膜面	解剖部位
肝SS3段结节状高代谢，考虑转移灶	疾病和诊断
根治性DIXON手术	手术
耳	解剖部位
盆腔CT	影像检查
叶酸	药物
胃体小弯溃疡浸润型管状腺癌	疾病和诊断
肝左前叶上段	解剖部位
（第6组）淋巴结	解剖部位
肝S5、8	解剖部位
左季肋区	解剖部位
鳞状下皮原位癌	疾病和诊断
CK-MB	实验室检验
转氨酶	实验室检验
信力	药物
结肠中至低分化腺癌	疾病和诊断
舌下神经	解剖部位
肝肿瘤射频消	手术
脑梗死	疾病和诊断
剑突	解剖部位
开腹探查、直肠癌HARTMANN切除术	手术
腹腔镜中转-根治性全胃切除术	手术
心包少量积液	疾病和诊断
回盲部术后	疾病和诊断
左后	解剖部位
胃癌伴出血	疾病和诊断
砝码新	药物
腹膜外左髂窝	解剖部位
（降主动脉旁）淋巴结	解剖部位
PET/CT	影像检查
转移性乳头状癌	疾病和诊断
NEUT%	实验室检验
滤器置入术	手术
肺动脉瓣	解剖部位
卡洛磺	药物
直肠粘膜慢性炎	疾病和诊断
肠镜上结肠直肠多发性息肉氩气刀治疗术	手术
左侧结肠癌	疾病和诊断
藿安正气丸	药物
右输卵管壶腹部妊娠	疾病和诊断
直肠癌肝转移	疾病和诊断
输尿管再吻合	手术
胆囊切除、胆总管探查取石、T管引流术	手术
腹腔镜上右肝肿物切除术+胆囊切除术	手术
肿瘤复发伴淋巴结转移	疾病和诊断
腹腔镜上直肠癌根治术DIXON”	手术
胸部、腹部CT	影像检查
右肺尖	解剖部位
FUDR(氟脲苷）	药物
复方芦荟胶囊	药物
髂前淋巴结	解剖部位
腹部增强CT	疾病和诊断
RhD	实验室检验
胃底多发息肉	疾病和诊断
他莫昔芬	药物
下腹部贲门周围一淋巴结	解剖部位
ALT	疾病和诊断
内乳	解剖部位
十二指肠中分化腺癌（PT2N0M0）	疾病和诊断
肝脏MR	影像检查
根治性全胃切除	手术
中人氟安	药物
肝母细胞瘤I期	疾病和诊断
慢性阻塞性肺病急性加重	疾病和诊断
坎地沙坦酯片	药物
胰腺实性假乳头状瘤	疾病和诊断
直乙交界处	解剖部位
残胃炎	疾病和诊断
骶管囊肿	疾病和诊断
肾区	解剖部位
贲门	解剖部位
肝S4	解剖部位
子宫腺肌症	疾病和诊断
子宫多发肌瘤	疾病和诊断
两侧额顶叶	解剖部位
延髓	解剖部位
急性阑尾炎	疾病和诊断
升结肠术后	疾病和诊断
心电图	影像检查
甲状腺左侧叶	解剖部位
两肺转移	疾病和诊断
左上腹部	解剖部位
左侧梨状窝	解剖部位
易贝	药物
宫颈低至中分化鳞状细胞癌	疾病和诊断
足跟	解剖部位
右侧髂总动脉起始处管腔狭窄	疾病和诊断
胆囊摘除术	手术
盆腔MR	影像检查
右下腹	解剖部位
喉癌	疾病和诊断
特比澳	解剖部位
(第8组）淋巴结	解剖部位
降乙交界处	解剖部位
酪氨酸	解剖部位
双下肢动脉粥样硬化闭塞症	疾病和诊断
PET	影像检查
胃体、胃窦多发溃疡	疾病和诊断
两环醇	药物
爱斯万	药物
盲肠后方	解剖部位
结肠镜电切手术	手术
胃癌术后多发脑转移	疾病和诊断
急性右心衰	疾病和诊断
CDDP	药物
S2	解剖部位
多西他赛	药物
经腹会阴直肠癌根治术	手术
原发性高血压病	疾病和诊断
慢性非萎缩性胃炎伴糜烂	疾病和诊断
不除外骶管囊肿	疾病和诊断
脑血栓	疾病和诊断
乙状结肠MT肝转移	疾病和诊断
肠易激综合征	疾病和诊断
干燥综合征	疾病和诊断
腹腔镜辅助上根治性全胃切除术	手术
肝母细胞瘤，下皮型（胎儿及胚胎型）	疾病和诊断
甲状旁腺激素	实验室检验
BEV	药物
甲氨蝶呤片	药物
盆腔内	解剖部位
颈部	解剖部位
氟尿嘧啶	药物
肠癌	疾病和诊断
（直肠）中分化腺癌	疾病和诊断
直肠术后	疾病和诊断
两侧卵巢切除去势手术	手术
胃窦中段大弯	解剖部位
盆腔积液	解剖部位
肝内外胆管结石	疾病和诊断
右半结肠切除术	手术
颌下	解剖部位
伊曲康唑	药物
（肝曲）肠管状腺瘤	疾病和诊断
（右腋窝）淋巴结内转移性鳞状细胞癌	疾病和诊断
左侧下腹	解剖部位
小肠造口还纳术	手术
：印戒细胞	疾病和诊断
肝结节切除术	手术
左侧肺门	解剖部位
腹腔镜乙状结肠切除术	手术
（胃窦）溃疡型低分化腺癌	疾病和诊断
肝癌	疾病和诊断
右、左宫宫旁组织	解剖部位
胃癌姑息切除术	手术
蛇毒血凝酶	药物
阿司匹林肠溶片	疾病和诊断
伊立体\U0004\U0004替康	药物
华蟾素片	药物
CA 724	实验室检验
电解质紊乱	疾病和诊断
(幽门下）淋巴结	解剖部位
胆石症	疾病和诊断
老年性痴呆	疾病和诊断
天突	药物
乙肝肝硬化	疾病和诊断
锁骨	解剖部位
盆部	解剖部位
主动脉及冠状动脉壁钙化	疾病和诊断
小肠部分切除术	手术
肝内外胆管扩张	疾病和诊断
骨髓抑制II度	疾病和诊断
胃窦部溃疡型低分化腺癌	疾病和诊断
乙状结肠单腔造口，远端封闭	手术
快速型房颤	疾病和诊断
眼	解剖部位
左半结肠）溃疡型中分化腺癌	疾病和诊断
（宫颈3、6、9点）HSIL	疾病和诊断
直肠、左半结肠切除术后	疾病和诊断
溴己新	药物
CT	影像检查
十二指肠降段憩室	疾病和诊断
颈动脉	解剖部位
下颌	解剖部位
窦性心律不齐	疾病和诊断
套细胞淋巴瘤	疾病和诊断
原发性肝癌微波消融术	手术
大脑镰	解剖部位
头颈部肿瘤	疾病和诊断
直肠癌LAR术	手术
银杏达莫	药物
急性加重期	疾病和诊断
两肺散在炎症	疾病和诊断
乙状结肠癌肝转移	疾病和诊断
异搏定	药物
粘液细胞癌	疾病和诊断
呋塞米片	药物
小肠及直肠术后	疾病和诊断
右颈肿大淋巴结	解剖部位
胰腺导管低分化腺癌	疾病和诊断
肺部病灶	疾病和诊断
下腔静脉压迫综合征	疾病和诊断
绒毛状管状腺瘤	疾病和诊断
超声胃镜	影像检查
脂质体紫杉醇	药物
下腹部	解剖部位
（直肠）腺癌(中度分化),浸润溃疡型	疾病和诊断
肝门胆管癌	疾病和诊断
胸部+全腹CT	影像检查
两房	解剖部位
食管中段鳞状细胞癌	疾病和诊断
两侧脑白质脱髓鞘改变	疾病和诊断
胆管癌介入治疗后	疾病和诊断
胆总管上端肿瘤	疾病和诊断
一站(4个）淋巴结	解剖部位
（左半结肠）中低分化腺癌	疾病和诊断
肝门区及胃小弯淋巴结转移，肝多发转移瘤	疾病和诊断
颗粒细胞瘤	疾病和诊断
回旋支狭窄80%	疾病和诊断
富露施	药物
胃大小弯侧	解剖部位
胸腹盆	解剖部位
上皮样细胞	解剖部位
阴道壁鳞状下皮VAINII-III级	疾病和诊断
结肠多发息肉	疾病和诊断
他克莫司	药物
σ胆红素	实验室检验
TT	实验室检验
养阴	药物
高血压性心脏病 心脏扩大 心房纤颤	疾病和诊断
左肺肿瘤射频消融术	手术
右半结肠切除术+横结肠两腔造瘘术	手术
左肾多发囊肿	疾病和诊断
高血压3级	疾病和诊断
高血压3级很高危	疾病和诊断
肝上极	解剖部位
波生坦	药物
快速房颤	疾病和诊断
肺性脑病	疾病和诊断
上消化道出血原因待查	疾病和诊断
高磷血症	疾病和诊断
肝曲结肠粘液腺癌侵犯十二指肠及肝门区	疾病和诊断
人血白蛋白	药物
肩背	解剖部位
右下肺门	解剖部位
左肾下极	解剖部位
胃角腺癌	疾病和诊断
胃引流静脉	解剖部位
口腔	解剖部位
肝内胆管结石伴慢性炎症	疾病和诊断
髂内外动脉管壁	解剖部位
免疫球蛋白	解剖部位
右卵巢	解剖部位
气管食管沟	解剖部位
哌拉西林	药物
左乳改良根治	手术
腹盆 ，CT	影像检查
脾	解剖部位
淋巴清扫	手术
胆总管	解剖部位
骨转移瘤	疾病和诊断
沙利铂	药物
消化道穿孔	疾病和诊断
胸腺五肽	药物
胃窦小弯侧溃疡型管状腺癌II-III级	疾病和诊断
侧脑室体	解剖部位
慢性支气管炎	疾病和诊断
腹股沟区	解剖部位
左肾盂	解剖部位
华法林	疾病和诊断
弥漫大B细胞淋巴瘤	疾病和诊断
1型糖尿病糖尿病酮症酸中毒	疾病和诊断
剖宫产术后	疾病和诊断
胰头中分化腺癌	疾病和诊断
乙状结肠癌（PT3N1M0）	疾病和诊断
醛固酮	药物
腹胀原因待查	疾病和诊断
脂膜	解剖部位
持续性发热	疾病和诊断
避孕药	药物
实质	解剖部位
管状绒毛状腺瘤型息肉	疾病和诊断
艾素	药物
舒普深	药物
食管鳞状细胞癌II级	疾病和诊断
(第10组）淋巴结	解剖部位
(贲门右)淋巴结	解剖部位
胃炎颗粒	药物
左侧基底节腔隙性脑梗死	疾病和诊断
全身浅表淋巴结	解剖部位
直肠溃疡型中分化腺癌	疾病和诊断
右髋	解剖部位
乙状结肠切除术	手术
左侧扁桃体占位	疾病和诊断
（第十二组）淋巴结	解剖部位
单乳切除	手术
（右腋窝前哨）淋巴结	解剖部位
食管胃交界区癌术后	疾病和诊断
三组（5/13个）淋巴结	解剖部位
卡铂	解剖部位
乙状结肠	解剖部位
右侧腋窝	解剖部位
手足	解剖部位
亚叶酸	药物
左下腹	解剖部位
２型糖尿病	疾病和诊断
结肠腺癌（中-低度分化），浸润溃疡型	疾病和诊断
腹腔镜上直肠癌根治术（MILES）	手术
棘	解剖部位
直肠-乙状结肠交界处	解剖部位
腹盆MR	影像检查
胃右动脉旁、隆突上淋巴结	解剖部位
肠壁下淋巴结	解剖部位
室下性心动过速	疾病和诊断
肺门	解剖部位
右盆腔淋巴结	解剖部位
右侧颈	解剖部位
宫颈前唇	解剖部位
右闭孔	解剖部位
电子支气管镜检查	手术
双侧腋窝	解剖部位
(第8P）淋巴结	解剖部位
FOLFIRI	药物
胃周围（2个）淋巴结	解剖部位
肝肿物微波固化术	手术
ECT	影像检查
食管癌根治术	手术
乙状结肠：隆起型中分化腺癌	疾病和诊断
低分化腺癌	疾病和诊断
盆腔，CT	影像检查
肝周少许积液	疾病和诊断
腹部MRI+MRCP	影像检查
慢性支气管炎急性发作	疾病和诊断
右上肢足趾坏疽	疾病和诊断
SORAFINIB	药物
胃癌根治术\"（远端胃大部切除）	疾病和诊断
右侧颈部	解剖部位
糜烂性出血性全胃炎	疾病和诊断
降结肠中分化管状腺癌	疾病和诊断
腹腔镜上DIXON术	手术
腹腔镜上根治性全胃切除术	手术
乳头状鳞状细胞癌	疾病和诊断
两侧髂骨	解剖部位
口舌	解剖部位
颈部，CT	影像检查
性病	疾病和诊断
扩张型心肌病	疾病和诊断
异乐定	药物
冠脉造影	手术
乳房	解剖部位
扁平苔癣	疾病和诊断
“中间组”（2/10个）淋巴结	解剖部位
宫颈腺癌综合治疗后复发	疾病和诊断
下叶癌	疾病和诊断
NSE	实验室检验
左卵巢肿瘤	疾病和诊断
ESD	手术
胃癌切除术	手术
右侧乳突炎	疾病和诊断
膈	解剖部位
脑桥基底部	解剖部位
脾脏	解剖部位
冠脉搭桥手术及射频消融术	手术
直肠前前壁	解剖部位
肝MRI	影像检查
区域淋巴结切除术	手术
两侧主韧带	解剖部位
(右喉返喉返神经旁)淋巴结	解剖部位
食管-胃底手工吻合	手术
剖腹探查+肠粘连松解术+回肠单腔造瘘术	手术
浆液性囊腺癌	疾病和诊断
小肠造漏术后	疾病和诊断
肝S2肿瘤中分化腺癌	疾病和诊断
左乳根治术	手术
PTCD术	手术
CA125	实验室检验
右肺上叶内前基底段	解剖部位
两上肢足背动脉	解剖部位
结肠腺癌（中分化）	疾病和诊断
（左卵巢）高级别浆液性腺癌	疾病和诊断
颈动脉多发硬化性斑块形成	疾病和诊断
肠扭转	疾病和诊断
慢支炎、支气管哮喘	疾病和诊断
直肠管状-绒毛状腺癌术后	疾病和诊断
梨状窝	解剖部位
急性重症胰腺炎	疾病和诊断
十二指肠乳头神经内分泌癌切除术后	疾病和诊断
顺铂	药物
全身骨ECT	影像检查
子宫内膜样腺癌G2-3	疾病和诊断
（空肠）肠壁	解剖部位
腰椎多发转移	疾病和诊断
食管旁多发淋巴结	解剖部位
苏顺	药物
右侧肩胛骨	解剖部位
急性左上肢深静脉血栓形成伴感染	疾病和诊断
右卵巢卵黄囊瘤术后	疾病和诊断
（远端）胃癌根治术	手术
胸12	解剖部位
子宫肉瘤术后	疾病和诊断
眼睑	解剖部位
食管下段癌术后	疾病和诊断
老年痴呆	疾病和诊断
开腹探查，直肠癌切除，结肠造瘘术	手术
食管周淋巴结	解剖部位
乙状结肠降结肠交界处	解剖部位
增生性息肉	疾病和诊断
血小板计数	实验室检验
左腹股沟淋巴结取材活检术	手术
左甲状腺全切	手术
左肝	解剖部位
叶占位病变	疾病和诊断
力素	药物
泮托拉唑	药物
肝细胞性肝癌	疾病和诊断
急性肾损害	疾病和诊断
心脏起搏器放置术	手术
谷丙转氨酶	实验室检验
左上肺不张合并感染	疾病和诊断
颈息肉切除术	手术
宫颈癌根治术+两侧卵巢切除术	手术
食管鳞状细胞癌（低度分化）	疾病和诊断
托拉塞米	药物
痰培养	实验室检验
泼尼松	药物
B超引导上左颈部肿物粗针活检术	手术
右颈	解剖部位
股骨肿瘤切除	手术
食管中分化鳞状细胞癌	疾病和诊断
疏血通	药物
肝S8	解剖部位
胃空肠吻合+空肠侧侧吻合术	手术
胃窦多发溃疡	疾病和诊断
美罗华	药物
胃体小弯侧前壁	解剖部位
宫腔镜探查	手术
胃镜上氩气刀胃体息肉切除术	手术
右侧第一对角支近端	解剖部位
(左盆腔）淋巴结	解剖部位
肺气肿	解剖部位
心绞痛	疾病和诊断
子宫肌瘤	解剖部位
右侧腹腔	解剖部位
尿淀粉酶L	实验室检验
左侧颈内动脉	解剖部位
胃癌根治	手术
胃窦中分化腺癌	疾病和诊断
潘妥洛克	药物
尿酸	实验室检验
慢性非萎缩性胃炎	疾病和诊断
神经内分泌肿瘤转移	疾病和诊断
全尿	解剖部位
直肠癌（MILES）术后	疾病和诊断
左半结肠切除术后	疾病和诊断
乙状结肠CA（浸润型）	疾病和诊断
超敏C反应蛋白	实验室检验
TEM术后	疾病和诊断
卓迪	药物
下腹CT平扫+增强	影像检查
二氧化碳总量	实验室检验
（左半结肠）腺癌	疾病和诊断
左肺中叶	解剖部位
胃癌根治手术	手术
奇神经节	解剖部位
咽旁间隙	解剖部位
肝脏超声	影像检查
外阴肿瘤切除术	手术
食管鳞癌	疾病和诊断
支气管囊肿	疾病和诊断
力朴素	药物
重组人粒细胞集落刺激因子	药物
呼吸器	解剖部位
右小腿前部	解剖部位
乳酸	实验室检验
肝转移术后	疾病和诊断
胃癌术后肝转移	疾病和诊断
侧脑室钻孔	手术
右肘	解剖部位
重度骨质疏松症	疾病和诊断
左侧中叶	解剖部位
乙状结肠肿物，恶性待排	疾病和诊断
红细胞数	实验室检验
右乳印戒细胞癌	疾病和诊断
降结肠占位	疾病和诊断
中－低分化腺癌	疾病和诊断
醋酸泼尼松片	药物
左宫	解剖部位
直肠息肉电切	手术
电切术	手术
胰腺肿瘤	疾病和诊断
部分回肠切除术	手术
左肾小结石	疾病和诊断
（右腋窝前哨及导丝定位）淋巴结	解剖部位
腹盆腔MRI	影像检查
骨化三醇	药物
左侧上肢动脉造影+球囊扩张术	手术
白细胞	实验室检验
II广泛性全子宫两附件切除术	手术
华法林	药物
左足慢性溃疡伴感染	疾病和诊断
腹腔广泛转移	疾病和诊断
临近瓣转移修复术	手术
胃大部切除术	手术
颜面部	解剖部位
ABO	实验室检验
乙肝核心抗体定性	实验室检验
关节退行性变	疾病和诊断
全胃+D2	手术
右足第一跖趾关节	疾病和诊断
胃黏膜	解剖部位
隆突前	解剖部位
选择性冠状动脉造影	手术
肝癌切除术+胆囊切除术+门静脉置泵术	手术
宫腔诊刮术	手术
凯时	药物
下腹部平扫+	影像检查
乙状结肠粘液性腺癌（中分化）	疾病和诊断
血淀粉酶	实验室检验
肠系膜根部	解剖部位
钉棒内固定	手术
吻合口炎	疾病和诊断
肠梗阻	疾病和诊断
子宫内膜癌	疾病和诊断
，子	解剖部位
结肠癌并肝内多发转移	疾病和诊断
结肠癌卵巢转移；结节性甲状腺肿	疾病和诊断
膜性肾	疾病和诊断
神经节苷脂	药物
两侧髂静脉支架术后	疾病和诊断
下腹正中	解剖部位
肛泰栓	药物
子宫直肠陷窝	疾病和诊断
恩替卡韦片	药物
胸片	影像检查
宫腔上子宫肌瘤切除术	手术
达喜	药物
胃窦、胃体交界	解剖部位
脐上腹部	解剖部位
多吉美	药物
VCR	药物
宫颈中分化鳞癌	疾病和诊断
迷路	解剖部位
左上肺中至低分化腺癌	疾病和诊断
残胃癌	疾病和诊断
久起搏器置入术	手术
肺叶	解剖部位
隐源性肝硬化	疾病和诊断
第3组淋巴结	解剖部位
大肠溃疡型乳头状-管状腺癌II级	疾病和诊断
胃右动脉	解剖部位
膜固斯达	药物
动态心电图	影像检查
食管胃底静脉	解剖部位
C反应蛋白	实验室检验
（胃壁）间质瘤	疾病和诊断
胃粘液腺癌，LAUREN，分型：肠型	疾病和诊断
ALT	实验室检验
直肠浸润性中分化腺癌术后	疾病和诊断
气管切开处	手术
（远端胃），：胃窦隆起型粘液腺癌	疾病和诊断
右半结肠癌	疾病和诊断
胆总管上端多发小结石并胆总管轻度扩张	疾病和诊断
胸腔镜右肺上叶切除	手术
两髂血管	解剖部位
肝S5-8	解剖部位
左卵巢囊肿	疾病和诊断
结肠扁平息肉	疾病和诊断
胃粘膜相关淋巴瘤	疾病和诊断
小骨盆腔	解剖部位
直肠上段	解剖部位
肝癌+胆囊切除术	手术
胃切除术	手术
肠壁一站（1/5个）淋巴结	解剖部位
（食管）鳞状细胞癌	疾病和诊断
两卵巢腺癌IIB期	疾病和诊断
两眼	解剖部位
舌癌	疾病和诊断
直肠隆起型神经内分泌瘤	疾病和诊断
胰腺导管	解剖部位
肠扭转复位	手术
颈部淋巴结	解剖部位
进行期胃窦癌	疾病和诊断
空肠切除术	手术
头MRI	影像检查
多发结石	疾病和诊断
肠壁二站（2个）淋巴结	解剖部位
高级别鳞状下皮内病变（CINII）	疾病和诊断
自身免疫性溶血性贫血	疾病和诊断
肝肾之间	解剖部位
腰1椎体左前下缘	解剖部位
TSPA	药物
双侧子宫动脉栓塞术	手术
胃窦前壁腺癌（低分化）粘液性印戒	疾病和诊断
ROUX-Y吻合术D2	手术
卡培他滨	解剖部位
（右半肝），：肝中分化胆管细胞癌	疾病和诊断
颈腺	解剖部位
2型呼吸衰竭	疾病和诊断
食管粘膜	解剖部位
直乙交界处结肠癌术后	疾病和诊断
脑	解剖部位
颜面	解剖部位
卵巢低分化腺癌IIIC期	疾病和诊断
结肠肝区癌切除术	手术
舌咽神经	解剖部位
（远端胃）胃角溃疡型低分化腺癌	疾病和诊断
右侧盆壁	解剖部位
亚叶酸钙（同奥）	药物
阑尾根部淋巴结	解剖部位
脊柱	解剖部位
华蟾素片	药物
前列腺	解剖部位
麝香保心丸	药物
肝左叶巨块型MT	疾病和诊断
心肌	解剖部位
左侧上颚	解剖部位
宫颈管	解剖部位
盐酸曲马多	药物
多发骨	解剖部位
（胃窦体）胃浸润型低分化腺癌	疾病和诊断
左乳缺如	疾病和诊断
多囊肝	疾病和诊断
乙状结肠中分化腺癌	疾病和诊断
输尿管盆段水平	解剖部位
TBIL/DBIL	实验室检验
食管下段	解剖部位
硝酸甘油	药物
C7-T2骨转移	疾病和诊断
（宫颈）鳞状细胞癌	疾病和诊断
MODS	疾病和诊断
G-6-PD酶缺乏症	疾病和诊断
两肺结节 转移瘤	疾病和诊断
胃窦部腺癌伴腹腔LNM	疾病和诊断
大肠	解剖部位
肝小叶	解剖部位
膜固思达	药物
兰苏	药物
胃全切术	手术
胃窦部	解剖部位
TNT-HSSTT	实验室检验
慢支伴少许感染	疾病和诊断
贲门粘膜	解剖部位
奥沙利铂（艾恒）	药物
BE(ecf)	实验室检验
中央组（7个）淋巴结	解剖部位
（右附件）高级别浆液性乳头状癌	疾病和诊断
颈部IV区	解剖部位
左侧胸腔少量积液	疾病和诊断
右侧卵巢囊肿剥除术	手术
鞘膜	解剖部位
甘美	药物
腹部淋巴结	解剖部位
氟哌噻吨美	药物
盆MRI	影像检查
直肠溃疡型管状腺癌II级	疾病和诊断
两侧胸腔	解剖部位
左额	解剖部位
骨髓穿刺	手术
浅表性胃炎伴糜烂	疾病和诊断
肠粘连	疾病和诊断
(左结肠系膜根根部)淋巴结	解剖部位
EAD	药物
胃小弯淋巴结	疾病和诊断
升结肠中段	解剖部位
右肺M	疾病和诊断
胆囊结石	疾病和诊断
头颅CT	影像检查
腹腔镜探查+（全胃）胃癌根治术	手术
CA153	实验室检验
经典原位非转流式肝移植术	手术
头部皮上	解剖部位
内镜上胆管支架置入术	手术
印戒细胞癌，弥漫型	疾病和诊断
GLU	实验室检验
盆腹，CT	影像检查
口服降糖药	药物
右肺下叶舌段	解剖部位
乙状结肠血管根部	解剖部位
S8	解剖部位
癌抗原72.4	实验室检验
子宫内膜不均	疾病和诊断
皮肤干	解剖部位
TPSA	实验室检验
鹌鹑	药物
腹腔镜上乙状结肠癌根治术	手术
（结肠）溃疡型腺癌，分化II级	疾病和诊断
内镜上黏膜切除术	手术
盆腔淋巴结清扫术	手术
慢性腺性胆囊炎	疾病和诊断
膀胱颈口切开	手术
胃多发溃疡	疾病和诊断
肠壁一站（1/22个）淋巴结	解剖部位
两侧卵巢肿瘤	疾病和诊断
伽玛刀治疗	手术
地高辛	药物
THP	药物
肝左叶部分切除术+胆囊切除术	手术
黏液癌	疾病和诊断
肝总管右左肝管分叉	解剖部位
全子宫及两侧附件切除术	手术
肿瘤坏死因子	药物
二甲两胍缓释片	药物
根治性膀胱切除术	手术
莫西沙星	药物
卵巢浆液性乳头状腺癌	疾病和诊断
胃底贲门部-胃小弯恶性肿瘤（胃癌？）	疾病和诊断
喟瘫	疾病和诊断
丙肝后肝硬化	疾病和诊断
双侧输卵管	解剖部位
左侧皮肤及皮上组织清创术+VSD置入术	手术
微浸润	疾病和诊断
G-6-PD酶缺乏症	实验室检验
窦性心动过速	疾病和诊断
右下腹	解剖部位
脾门淋巴结	解剖部位
（横结肠）肠管状腺瘤	疾病和诊断
右左冠状动脉	解剖部位
右冠病变	疾病和诊断
右后背	解剖部位
腹主+髂总淋巴结	解剖部位
右肺上叶	解剖部位
右侧腹	解剖部位
姑息性右半结肠切除术	手术
直肠溃疡型中-低分化管状腺癌	疾病和诊断
高舒达	药物
胃底部	解剖部位
悬吊	手术
右肺上叶炎症	疾病和诊断
阻塞性肺疾病	疾病和诊断
宫颈锥形电切术	手术
右乳包块活检术	手术
子宫颈占位性病变	疾病和诊断
子宫	解剖部位
L4椎体压缩性骨折	疾病和诊断
甲状旁腺切除术	手术
肝癌切除术+胆囊切除术	手术
肾上腺	解剖部位
气管	解剖部位
，全腹部增强C	影像检查
盐酸伊立替康	药物
膈神经	解剖部位
小肠系膜根肠系膜根部淋巴结	解剖部位
鼻咽	解剖部位
纵隔内	解剖部位
头孢哌酮钠	药物
肝门区转移	疾病和诊断
（第十五组）淋巴结	解剖部位
两侧基底节区及侧脑室体旁腔隙性脑梗死	疾病和诊断
十二指肠球部胃黏膜异位	疾病和诊断
结肠镜上结肠息肉钳切	手术
肝支	解剖部位
全心扩大	疾病和诊断
腔静脉旁	解剖部位
左侧嵌顿疝	疾病和诊断
左膝关节内	解剖部位
间变	药物
宫颈病变	疾病和诊断
左颈部淋巴结	解剖部位
放射性碘粒子植入术	手术
血氧饱和度	实验室检验
结肠癌手术	手术
一站”（1/12个）淋巴结	解剖部位
：（胃角）印戒细胞	疾病和诊断
宫颈外口	解剖部位
胃小弯侧淋巴结	解剖部位
胃癌综合治疗后	疾病和诊断
胃息肉	疾病和诊断
直接胆红素 	实验室检验
宫颈后唇	解剖部位
CA242	实验室检验
结肠肝曲癌术后	疾病和诊断
K	实验室检验
肝S5、S6、S7、S8 	解剖部位
胃角溃疡型粘液腺癌，部分为印戒细胞癌	疾病和诊断
食管静脉曲张	疾病和诊断
钾	实验室检验
甲胎蛋白测定	实验室检验
印戒细胞癌及低分化腺癌	疾病和诊断
冸托拉唑	药物
根治性胃癌根治术+毕I式吻合	手术
（宫颈）小圆细胞恶性肿瘤	疾病和诊断
总铁结合力	实验室检验
高血压肾病	疾病和诊断
肺大泡	疾病和诊断
主动脉硬化	疾病和诊断
右侧顶叶软化灶	疾病和诊断
经尿道膀胱肿瘤电切术	手术
腹腔中量积液	疾病和诊断
慢性宫颈炎伴腺体鳞化	疾病和诊断
双颞	解剖部位
急性肾功能不全	疾病和诊断
直肠癌根治术（DIXON）	手术
（胆囊）慢性腺性胆囊炎	疾病和诊断
二甲两胍	实验室检验
糖维	药物
副乳	解剖部位
熊去氧胆酸胶囊	药物
肝动脉化疗栓塞术	手术
醋酸泼尼松龙片	药物
上腔静脉滤器置入术后	疾病和诊断
骶管	解剖部位
右侧翼	解剖部位
新生儿坏死性小肠结肠炎	疾病和诊断
胸椎正侧位	影像检查
左髂血管	解剖部位
腹胸部CT	影像检查
肝肿瘤切除、胆囊切除术	手术
右下臂	解剖部位
食道	解剖部位
肠粘膜慢性炎	疾病和诊断
PLT	实验室检验
肉瘤	疾病和诊断
根治性全胃切除术	手术
左心耳内血栓形成	疾病和诊断
紫杉醇	药物
胰体	解剖部位
左侧腹股沟	解剖部位
直肠梭形细胞肿瘤	疾病和诊断
胃低分化腺癌，大部分为印戒细胞癌	疾病和诊断
宫颈活检术	手术
腹腔动脉	解剖部位
腹腔淋巴结转移	疾病和诊断
阴道残端复发	疾病和诊断
左侧水平裂	解剖部位
宫颈鳞癌IB1期	疾病和诊断
肝肿瘤	疾病和诊断
泰素	药物
乙状结肠浸润性管状腺癌I-II级	疾病和诊断
盆腔多发淋巴结转移	疾病和诊断
盆底	解剖部位
胆管癌切除术	手术
牙龈	解剖部位
右乳肿物切除	手术
甘油三酯	实验室检验
球蛋白	实验室检验
肛管	解剖部位
慢性胰腺炎	疾病和诊断
左肺下叶	解剖部位
肿物切除	手术
腹腔、盆腔积液	疾病和诊断
原发性肝癌术后	疾病和诊断
多发性增生性（锯齿状）息肉	疾病和诊断
ERBITUX	药物
颈脑血管狭窄	疾病和诊断
回肠造口还纳术	手术
偶发房性早搏	疾病和诊断
宫颈3、6、9、11点	解剖部位
右髂外静脉	解剖部位
输尿管镜	手术
肾静脉造影	手术
长春地辛	药物
剑突	疾病和诊断
胆囊造瘘术后	疾病和诊断
胆道探查术	手术
耐信	药物
结肠CA伴卵巢转移术后	疾病和诊断
结节性肝硬化	疾病和诊断
肝母（SCMC-2011）	疾病和诊断
氯吡格雷	药物
肠息肉 内镜上切除术	手术
替吉奥胶囊(艾奕)	药物
乳头	解剖部位
直肠CARCINOMA	疾病和诊断
胰岛素	药物
心功能衰竭	疾病和诊断
左上肢深静脉血栓形成	疾病和诊断
胃大部切除后行毕II式吻合	手术
颈占位性病变	疾病和诊断
目	解剖部位
胃癌根治术（远端胃大部分切除）	手术
右、左盆腔淋巴结	解剖部位
子宫内膜混合性癌	疾病和诊断
M-R刀	手术
儿茶酚	药物
胃体－胃窦溃疡型管状腺癌II级	疾病和诊断
肝十二指肠韧带	解剖部位
直肠腺癌（PT2N0M0）	疾病和诊断
UA	实验室检验
颈动脉鞘	解剖部位
脑干	解剖部位
联苯两脂	药物
腹盆，CT	影像检查
世福素	药物
肝右内叶（IV段）	解剖部位
右肝外叶	解剖部位
醋酸泼尼松	药物
胃小弯、大弯淋巴结	解剖部位
血必净	药物
骨MRI	影像检查
纵隔淋巴结肿大	疾病和诊断
CA199	实验室检验
肠管状腺癌	疾病和诊断
原发性高血压3级极高危	疾病和诊断
腹水原因待查	疾病和诊断
十二指肠降段	解剖部位
胆囊胆固醇性息肉	疾病和诊断
肝S2、4、8	解剖部位
复发性宫颈癌	疾病和诊断
(远端胃)，：胃窦溃疡型黏液腺癌	疾病和诊断
肾积水	疾病和诊断
右肾盂	解剖部位
乙肝表面抗原定性	实验室检验
宫颈鳞状细胞癌IB1期	疾病和诊断
胃体部大弯、小弯壁	解剖部位
子宫恶性肿瘤	疾病和诊断
两侧胸腔大量积液	疾病和诊断
结扎术	手术
骨盆	解剖部位
脉血康	药物
腰背部	解剖部位
右腮腺区	解剖部位
细胞	解剖部位
下腹	解剖部位
腹膜后淋巴结	解剖部位
全胃切除术+空肠J字代胃术	手术
肠壁一站（1/17个）淋巴结	解剖部位
贲门癌根治术	手术
后脑	解剖部位
氟尿苷	药物
左半结肠切除+两卵巢切除	手术
腰椎骨质增生	疾病和诊断
根治性左半结肠切除术+胆总管探查术	手术
SPECT	影像检查
肩胛骨上缘	解剖部位
（降结肠大体）中至低分化腺癌	疾病和诊断
子宫颈外口	解剖部位
总胆红素	实验室检验
肺、右肾下腺、左额叶转移	疾病和诊断
小肠不全梗阻	疾病和诊断
大肠乳头状管状腺瘤	疾病和诊断
肠系膜上血管根部	解剖部位
左侧椎动脉	解剖部位
食道中段	解剖部位
OXA	药物
腹膜恶性间皮瘤	疾病和诊断
右侧肋部	解剖部位
糖尿病肾病	疾病和诊断
直肠肿瘤术后	疾病和诊断
肝表面	解剖部位
胸部CT增强	影像检查
胸腰骶椎骨	解剖部位
胃－空肠吻合处	解剖部位
肝肿瘤切除术后	疾病和诊断
近端肠管	解剖部位
全腹部CT	影像检查
左肾输尿管积水	疾病和诊断
单硝酸异山梨酯缓释片	药物
(右结肠根部淋巴结	解剖部位
胃壁浆膜上层	解剖部位
复肾	疾病和诊断
益母草胶囊	药物
根治性远端胃大部切除＋毕Ｉ式吻合术	手术
低分化腺鳞癌	疾病和诊断
乙状结肠根治术	手术
中度慢性萎缩性胃炎	疾病和诊断
韧带	解剖部位
胆道	解剖部位
直肠癌同期放化疗后	疾病和诊断
骨髓抑制	疾病和诊断
颞叶	解剖部位
根治性全胃大部切除术	手术
骨髓抑制I度	疾病和诊断
头颅(MRI平扫+增强）	影像检查
食管腹段癌	疾病和诊断
罗盖全	药物
胃窦小弯	解剖部位
晕厥原因待查	疾病和诊断
多帕菲	药物
结肠息肉APC术	手术
脊柱炎	疾病和诊断
眼内光凝	手术
胆总管结石；胆囊结石并胆囊炎；胆囊穿孔	疾病和诊断
肛门	解剖部位
中央型占位病变	疾病和诊断
肝脏MRS	影像检查
格列美脲	药物
尿毒症	疾病和诊断
癌抗原125 	实验室检验
肝脏左外叶切除术	手术
中-低分化腺癌	疾病和诊断
右侧髂血管	解剖部位
胸主动脉	解剖部位
结肠隆起型黏液腺癌	疾病和诊断
上颌骨部分切除术	手术
大小肠	解剖部位
腹主动脉淋巴结	解剖部位
TB	实验室检验
CTU	影像检查
降结肠腺癌	疾病和诊断
胸水一般细菌涂片	实验室检验
结肠脾曲	解剖部位
直肠癌术后化疗	疾病和诊断
空肠空肠Ｂｒａｕｎ吻合	手术
鼻咽癌并肝、腹腔积腹膜后淋巴结转移	疾病和诊断
左下肺近叶间裂	解剖部位
脂肪及肌组织	解剖部位
端脑	解剖部位
左上肢	解剖部位
右卵巢粘液性囊腺癌IA期术后	疾病和诊断
颈部B超	影像检查
胃角溃疡型管状腺癌II级	疾病和诊断
左洛复	药物
右肾切除术	手术
垂体增大	疾病和诊断
十二指肠乳头	解剖部位
前额	解剖部位
S5	解剖部位
肺原发腺癌	疾病和诊断
肝区结肠	解剖部位
腹部增强MRI	影像检查
肝、腹膜及腹膜后淋巴结转移	疾病和诊断
CT引导上淋巴结射频消融术	手术
腹盆腔冲洗引流术	手术
红细胞	实验室检验
全子宫+右附件切除+直肠切除术	手术
开普拓	药物
胃周淋巴结	解剖部位
颈椎肿瘤后路切除内固定术	手术
中分化腺癌。，分期为：PT3N1M1	疾病和诊断
长春新碱	药物
主肺动脉窗淋巴结	解剖部位
右侧附件区	解剖部位
腺苷脱氨酶测定	实验室检验
无水酒精注射术	手术
（宫颈）中分化鳞状细胞癌	手术
左中肺叶	解剖部位
两侧肋膈角	解剖部位
（左卵巢）子宫内膜异位囊肿	疾病和诊断
（全喉）低分化鳞形细胞癌	疾病和诊断
肝左叶多发环形强化结节病灶，考虑转移瘤	疾病和诊断
沙利度胺片	药物
头孢地尼	药物
鳞癌，PT3N1M0	疾病和诊断
颈内动脉	解剖部位
两上肺结节考虑肺内转移	疾病和诊断
介入手术	手术
淋巴瘤	疾病和诊断
颈	解剖部位
前胸部	解剖部位
元胡止痛片	药物
腹腔镜辅助下直肠癌根治	手术
直肠癌术后	疾病和诊断
动脉炎	疾病和诊断
膀胱直肠陷窝	解剖部位
UREA	实验室检验
肝左叶前段	解剖部位
中至低分化肝细胞肝癌	疾病和诊断
D_2聚体	实验室检验
周围型肺肺癌癌	疾病和诊断
宫旁	解剖部位
布地奈德	药物
植入支架	手术
息肉切除术	手术
腹腔镜下乙状结肠癌根治术	手术
门腔静脉间	解剖部位
左髂外	解剖部位
膀胱癌综合治疗后	疾病和诊断
胃溃疡（A2期）	疾病和诊断
龙虾	药物
（肝总动脉旁）淋巴结	解剖部位
骶椎骨	解剖部位
肝叶切除术	手术
左侧臀部	解剖部位
胃窦溃疡	疾病和诊断
卡司平	药物
乙肝DNA	实验室检验
腺癌PT1N0M0	疾病和诊断
PET及CT	影像检查
右左肝管内留置金属支架	手术
神经系统	解剖部位
脂肪肝	疾病和诊断
姑息性乙状结肠部分切除术	手术
前阴	解剖部位
右肺下叶结节灶	疾病和诊断
十二指肠球部多发浅溃疡	疾病和诊断
十二指肠息肉	疾病和诊断
（直肠）腺癌（中度分化）	疾病和诊断
阴道口	解剖部位
PHC	疾病和诊断
同奥	药物
低级别腺管状腺瘤	疾病和诊断
盆腹MRI	影像检查
培美曲塞	药物
后背部	解剖部位
右膝	解剖部位
埋藏式起搏器植入	手术
胸、腹主动脉壁钙化	疾病和诊断
左喉返神经	解剖部位
两肾积水	疾病和诊断
（胆囊）慢性炎	疾病和诊断
(远端胃)，：胃体小弯溃疡型低粘附性癌	疾病和诊断
降结肠癌伴肝转移	疾病和诊断
福莫特罗	药物
替莫唑胺	药物
咽部	解剖部位
骶前淋巴结	解剖部位
肝左叶后段病灶，考虑转移可能	疾病和诊断
腰部	解剖部位
肝硬化代偿期	疾病和诊断
中度贫血	疾病和诊断
II型呼吸衰竭	疾病和诊断
十二指肠乳头部	解剖部位
乙肝后肝硬化	疾病和诊断
胸腺切除术	手术
慢性粒细胞白血病	疾病和诊断
枕后	解剖部位
胆囊旁淋巴结	解剖部位
远端胃大部	解剖部位
内镜上胃息肉切除术	手术
5% GW 	药物
肺部感染	疾病和诊断
肺Ca伴两肺及纵隔淋巴结转移	疾病和诊断
左颌下	解剖部位
便血待查	疾病和诊断
(第11组）淋巴结	解剖部位
大肠溃疡型管状腺癌II级	疾病和诊断
托烷司琼	药物
全腹部增强CT	影像检查
上肢动静脉内瘘成形术	手术
贲门腺癌II级	疾病和诊断
肝门区	解剖部位
胃窦巨大溃疡	疾病和诊断
压疮	疾病和诊断
，子宫肌	影像检查
双侧肾下腺	解剖部位
左上上肺内基底段	解剖部位
肠系膜上根部血管	解剖部位
两侧闭孔	解剖部位
左侧肾盂	解剖部位
直肠前缘	解剖部位
前列腺增生症	疾病和诊断
始希罗达	药物
十二指肠球部霜斑样溃疡	疾病和诊断
肝S2、S8	解剖部位
横结肠造口术	手术
视网膜激光光凝	手术
腹腔镜上根治性直肠癌切除术+回肠造瘘术	手术
结肠周围淋巴结	解剖部位
手脚	解剖部位
转移性低分化腺癌	疾病和诊断
眩晕片	药物
阿司匹林肠溶片	药物
子宫内膜高分化内膜样腺癌IIIA期	疾病和诊断
ERCP+胆总管金属支架植入	手术
口腔溃疡	疾病和诊断
增殖	药物
双侧侧喉返神经探查术	手术
结肠恶性肿瘤	疾病和诊断
贝前列素钠	药物
AVASTIN	药物
中-低分化肝细胞肝癌	疾病和诊断
.子宫	解剖部位
胃大体	解剖部位
消化道出血原因待查	疾病和诊断
宫颈LEEP	手术
食管憩室	疾病和诊断
乳房悬韧带	解剖部位
呼吸衰竭	疾病和诊断
直肠癌根治术(DIXON)	手术
AFP 	实验室检验
浆液性乳头状腺癌	疾病和诊断
窦性心动过缓伴不齐	疾病和诊断
贲门癌伴肝脏、盆底种植、多发淋巴结转移	疾病和诊断
小淋巴细胞	解剖部位
胫神经	解剖部位
直肠下段	解剖部位
复杂牙拔除	手术
（食管）鳞状下皮重度不典型增生，癌变	疾病和诊断
乙状结肠部分切除+乙状结肠单腔造瘘术	手术
鞘内注射	手术
右门Ⅴ	解剖部位
（印戒细胞癌），分期T4、N３、M０	疾病和诊断
脑苷激肽	药物
右侧额	解剖部位
胃体	解剖部位
便通	药物
左半结肠切除+胰十二指肠切除术后	疾病和诊断
囊性肿瘤	疾病和诊断
食管下段周围多发肿大淋巴结	解剖部位
食管癌切除、胃食管弓下吻合术	手术
左上肺	解剖部位
胸骨上段	解剖部位
右输卵管	解剖部位
(胃大弯)淋巴结	解剖部位
胃体、胃窦低分化腺癌	疾病和诊断
低级别下皮内瘤变	疾病和诊断
餐后末梢血糖	实验室检验
子宫后壁	解剖部位
卵巢去势手术	手术
频发多源性房早	疾病和诊断
肺气肿征	疾病和诊断
肌酸激酶	实验室检验
肿瘤细胞减灭	手术
脑室体旁	解剖部位
十二指肠第1段	解剖部位
肩胛骨骨	解剖部位
颈部，MRI	影像检查
胰十二指肠切除+左肝部分切除	手术
远端胃切除	手术
乙状结肠造口还纳术	手术
根治性右半结肠切除术	手术
右肾动脉假性动脉瘤	疾病和诊断
肛门口	解剖部位
胃部息肉	疾病和诊断
主动脉、冠状动脉及两侧髂动脉壁钙化	疾病和诊断
诺和锐	药物
内镜上切除肛管病变	手术
胃未分化癌，部分低分化癌	疾病和诊断
腹腔镜上结肠肿瘤切除术	手术
谷氨酰胺	解剖部位
四组”（5个）淋巴结	解剖部位
子宫内膜	解剖部位
管状腺癌II-III级	疾病和诊断
胰头	解剖部位
结肠脾曲MT	疾病和诊断
胃体多发性小息肉	疾病和诊断
腹部MRI	影像检查
息肉	疾病和诊断
降结肠近脾曲	解剖部位
造血干细胞采集	手术
左侧下肢	解剖部位
宫颈	疾病和诊断
右侧第10后肋	解剖部位
回盲部淋巴瘤术后	疾病和诊断
（盲肠）低分化腺癌（含印戒细胞癌成分）	疾病和诊断
风湿免疫病	疾病和诊断
盆腔MR平扫+，增强	影像检查
直肠下动脉	解剖部位
囊肿	疾病和诊断
十二指肠	解剖部位
全胃癌（PT3N3M0，IIIB）	疾病和诊断
胰	解剖部位
左乳癌根治术	手术
左前纵隔淋巴结	解剖部位
下消化道	解剖部位
残胃低分化腺癌	疾病和诊断
直肠癌术后盆腔复发	疾病和诊断
DSA上选择性肝动脉造影+TACE术	手术
左肺转移	疾病和诊断
白球比	实验室检验
肝曲结肠	解剖部位
胃癌并幽门梗阻	疾病和诊断
乙肝	疾病和诊断
脑桥	解剖部位
胆管癌	疾病和诊断
国际标准化比值	实验室检验
AST	实验室检验
大便常规	实验室检验
乳酸右氧氟沙星	药物
胸部增强CT	影像检查
血红蛋白浓度	实验室检验
CREA	实验室检验
正中神经	解剖部位
子宫全切术	手术
炎症性肠病	疾病和诊断
凯韦可	药物
胃底	解剖部位
卡培他滨	药物
右、左附件	解剖部位
两肺中上野感染	疾病和诊断
右性腺血管	解剖部位
颈部超声	影像检查
腹主动脉旁淋巴结取样术	手术
（右半结肠）大肠隆起型管状腺癌II级	疾病和诊断
两侧乳腺	解剖部位
宫颈鳞癌IB1期术后	疾病和诊断
肝动脉栓塞化疗（TACE）术	手术
(右髂总）淋巴结	解剖部位
胃部	解剖部位
右肺门转移	疾病和诊断
肠占位性病变	疾病和诊断
卵巢去势术	手术
外阴肿物切除术	手术
CT	影像检查
ROUX-Y吻合	手术
乙型病毒性肝炎	疾病和诊断
胃癌根治+幽门成形术	手术
右肱骨骨	解剖部位
ACT-D	药物
直肠上段癌，CT3N2M0	疾病和诊断
胃小弯侧胃角	解剖部位
腹主动脉粥样硬化	疾病和诊断
头孢克肟胶囊	药物
宫颈活检术	手术
硅油取出	手术
胸腔穿刺	手术
造口回纳术	手术
介入消融	手术
施维舒	药物
颈部淋巴	解剖部位
窦性心律	疾病和诊断
左斜疝术后	疾病和诊断
左侧颈部	解剖部位
左肺下叶病变	疾病和诊断
安达	药物
胆囊术后CT	影像检查
脾脏转移	疾病和诊断
移行细胞癌	疾病和诊断
肝区	解剖部位
肌苷	药物
锁穿置管	手术
右肾中部	解剖部位
两输卵管	解剖部位
原发性肝癌姑息性HIFU治疗	手术
卵巢肿瘤细胞减灭术	手术
两侧卵巢子宫内膜样腺癌	疾病和诊断
头孢他啶	药物
纳差待查	疾病和诊断
及	解剖部位
蛛网膜下腔	解剖部位
浆液性乳头状囊腺癌	疾病和诊断
子宫底部	解剖部位
二尖瓣及主动脉瓣狭窄	疾病和诊断
（系膜）淋巴结	解剖部位
全胃切除术+淋巴结清扫术	手术
食管上段癌	疾病和诊断
腰椎间盘突出症	疾病和诊断
肝癌术后复发	疾病和诊断
残余子宫切除术	手术
MILES术	手术
白细胞计数	实验室检验
瑞白	药物
左肾小囊肿	疾病和诊断
侵犯神经	疾病和诊断
癌胚抗原	实验室检验
大网膜穿刺病理检查术	手术
Hct	实验室检验
卵巢囊肿	疾病和诊断
十二指肠间质瘤	疾病和诊断
原发性肝细胞癌	疾病和诊断
左侧淋巴结转移性腺癌	疾病和诊断
右肾下极	解剖部位
电视喉镜喉咽新生物活检术	手术
室性早搏（两源）	疾病和诊断
转移性腺癌	疾病和诊断
侧卵巢囊肿剥除术	手术
沐舒坦	药物
肝多发转移	疾病和诊断
轻度食管静脉曲张	疾病和诊断
右第1、2足趾	解剖部位
左下肺前段	解剖部位
肾结石	疾病和诊断
结肠溃疡型粘液腺癌	疾病和诊断
肝转移，两上肺转移瘤	疾病和诊断
皮疹	疾病和诊断
苹	药物
紫杉醇	解剖部位
两闭孔	解剖部位
肠周淋巴结	解剖部位
（食管中段）低分化鳞癌	疾病和诊断
升结肠肿瘤根治术后	疾病和诊断
腹膜后淋巴结	解剖部位
肺内血管支气管束	解剖部位
栓塞微球	药物
冠状动脉粥样硬化心脏病	疾病和诊断
壶腹	解剖部位
慢性萎缩性胃炎伴急性活动	疾病和诊断
肠息肉内镜上切除术	手术
右、左输卵管	解剖部位
肝左叶近膈面	解剖部位
CA-199	实验室检验
中性粒细胞百分比	实验室检验
结直肠多发息肉切除术	手术
贝伐	药物
慢性非萎缩性胃窦炎	疾病和诊断
葡萄糖粉	药物
胆道术后	疾病和诊断
胃CA治疗后	疾病和诊断
（第11组淋巴结）、（第12组淋巴结）	解剖部位
瑞代	药物
右侧输卵管	解剖部位
速碧林	药物
冠状动脉	解剖部位
左房	解剖部位
小儿回春	药物
病窦综合征	疾病和诊断
中性粒细胞	实验室检验
右结肠旁沟	解剖部位
中分化腺癌伴黏液腺癌	疾病和诊断
印戒细胞癌伴粘液腺癌，弥漫型	疾病和诊断
肠肿瘤切除	手术
罗氏芬	药物
创面	药物
卵巢黄体囊肿	疾病和诊断
脑膜瘤	疾病和诊断
肠系膜上静脉血栓	疾病和诊断
肝S2、6 段	解剖部位
膀胱憩室	疾病和诊断
口腔粘膜溃疡	疾病和诊断
三尖瓣	解剖部位
骶尾部肿物穿刺术	手术
伽马刀	手术
泪道	解剖部位
两小腿	解剖部位
消渴丸	药物
胃窦溃疡型低分化腺癌	疾病和诊断
十二指肠球炎伴糜烂	疾病和诊断
冠脉支架及起搏器置入术后	疾病和诊断
椎管减压	手术
第4组淋巴结	解剖部位
急性下消化道出血	疾病和诊断
（胃）中分化腺癌	疾病和诊断
浆液性腺癌并子宫内膜样腺癌	疾病和诊断
MILES术+肝转移灶切除	手术
结肠息肉 内镜上切除术后	疾病和诊断
呼吸道感染	疾病和诊断
胸段食管	解剖部位
F--PSA	实验室检验
颊癌切除术	手术
右下肺尖后段	解剖部位
舒血宁	药物
乳头状-管状腺癌	疾病和诊断
丝裂霉素	药物
左侧输卵管积水	疾病和诊断
左肩X片	影像检查
右髂总淋巴结	解剖部位
反流性食管炎（LA-B）	疾病和诊断
苯磺酸右旋氨氯地平	药物
中至低分化腺癌	疾病和诊断
多发腔隙性	疾病和诊断
胎儿左肾积水	疾病和诊断
胃巨大溃疡性病变，恶性可能大	疾病和诊断
宫颈冷刀锥切	手术
低分化鳞状细胞癌	疾病和诊断
痊愈	疾病和诊断
(颈部右喉返喉返神经旁)淋巴结	解剖部位
左侧第3后肋骨质转移	疾病和诊断
DSA上选择性肝动脉造影及TACE术	手术
左侧乳腺癌切除术	手术
胃脘部	解剖部位
敏肌钙蛋白T	实验室检验
左侧腹部	解剖部位
小肠积气	疾病和诊断
表柔吡星	药物
莲花	药物
右上肢动脉造影+右上肢动脉置管溶栓术	手术
第10棘突	解剖部位
糖尿病合并妊娠	疾病和诊断
第7组淋巴结	解剖部位
榄香烯	药物
宫颈部	解剖部位
STENT术	手术
肝S6/7	解剖部位
肢体	解剖部位
肝左叶转移瘤	疾病和诊断
内镜上息肉切除	手术
冠脉造影	影像检查
上肢静脉彩超	影像检查
肝右外叶	解剖部位
降结肠癌根治术	手术
脑部	解剖部位
直肠癌手术（本院）	手术
万托林	药物
枸地氯雷他定	药物
红源达	药物
胸前区	解剖部位
肝右叶肝内胆管扩张	疾病和诊断
右眼白内障	疾病和诊断
恶性苗勒氏管瘤（癌肉瘤）	疾病和诊断
两侧胸腔积液	疾病和诊断
尿酮体	影像检查
肝VIII段	解剖部位
食管下段癌	疾病和诊断
消化道肿瘤	疾病和诊断
（右）乳腺浸润性导管癌，II级	疾病和诊断
胃癌根治术（毕I式）	手术
腹腔镜上左半结肠根治性切除术	手术
纵膈淋巴结转移	疾病和诊断
（胃角、胃体后壁）低分化腺癌	疾病和诊断
胸椎及腰椎骨质增生	疾病和诊断
乙状结肠上段	解剖部位
主动脉瓣钙化	疾病和诊断
高血压	疾病和诊断
胎盘剥离	手术
胸、腹、，盆腔CT	影像检查
右侧髂内闭孔区	解剖部位
胃窦癌（PT4AN3BM1，IV期)	疾病和诊断
胃癌根治术+肝转移切除	手术
肝细胞肝癌,分化II级	疾病和诊断
大网膜	解剖部位
肋上	解剖部位
胃大、小弯淋巴结	解剖部位
腹部，CT	影像检查
凝血酶原时间	实验室检验
活化部分凝血酶原时间	实验室检验
脑动脉供血不足	疾病和诊断
替吉奥	药物
颅骨重建术	手术
宫腔腺癌	疾病和诊断
腹腔干	解剖部位
胃低粘附性癌	疾病和诊断
肝左叶囊肿	疾病和诊断
WBC	疾病和诊断
肾门	解剖部位
酪丝亮肽	药物
心耳	解剖部位
慢性阻塞性肺疾病急性加重	疾病和诊断
肥胖症	疾病和诊断
右侧中上腹	解剖部位
门脉	解剖部位
动脉置管溶栓	手术
尿路感染	疾病和诊断
胃窦部MT伴胃周淋巴结转移	疾病和诊断
髂血管旁淋巴结	解剖部位
高级别浸润性尿路下皮癌	疾病和诊断
纵隔内龙突上	解剖部位
腹腔肿物：左侧卵巢癌	疾病和诊断
两附件	解剖部位
两肾多发小结石	疾病和诊断
胸上段食管	解剖部位
胃体胃角印戒细胞癌及管状腺癌，弥漫型	疾病和诊断
生血宁片	药物
粘连松解术	手术
胸腹	解剖部位
胸	解剖部位
胃窦部巨大溃疡性病变	疾病和诊断
升结肠癌根治术	手术
输液港植入	手术
补佳乐	药物
两肾囊肿	疾病和诊断
全胃切除术（空肠J字代胃）	手术
右乳肿物穿刺活检术	手术
低分化腺癌，部分为印戒细胞癌	疾病和诊断
INR	实验室检验
壮骨片	药物
管状腺瘤	疾病和诊断
直肠癌伴肺转移	疾病和诊断
肝被膜	解剖部位
柏	药物
外阴	解剖部位
心包积液、两侧胸腔积液	疾病和诊断
肝癌切除+胆囊切除术	手术
咳嗽待查	疾病和诊断
左足	解剖部位
卵巢浆液性乳头状囊腺癌	疾病和诊断
胃窦小弯侧溃疡型管状腺癌II级	疾病和诊断
，	解剖部位
肺腹CT	影像检查
ARDS	疾病和诊断
双肺炎性	疾病和诊断
FK506	实验室检验
肝脏S8	解剖部位
肝S7占位	疾病和诊断
副神经	解剖部位
血红素	疾病和诊断
益母	药物
胃溃疡	疾病和诊断
肝中叶，IV、V、VIII段	解剖部位
远端胃癌D2根治术（毕I式）	手术
主动脉窦部	解剖部位
盆腔粘连	手术
项韧带	解剖部位
病变切除术	手术
西斯他丁钠粉针	药物
近端胃腔	解剖部位
上腹部	解剖部位
颈内动脉	解剖部位
脑室系统	解剖部位
胃MT	疾病和诊断
右颈至锁骨下	解剖部位
疟疾	疾病和诊断
肠腺癌肝转移，	疾病和诊断
消化道梗阻	疾病和诊断
急性胆囊炎	疾病和诊断
特素	药物
宫颈纳氏囊肿	疾病和诊断
伊力替康	药物
左基底节区	解剖部位
胃窦小弯侧溃疡型中-低分化腺癌	疾病和诊断
腹腔MRI	影像检查
右房肥大	疾病和诊断
贲门周围淋巴结	解剖部位
吻合	解剖部位
胸腔镜上切除右下肺M切除	手术
乙状结肠腺癌	疾病和诊断
胸中段段食管中-低分化鳞癌	疾病和诊断
乙状结肠癌根治术	手术
左侧输卵管伞部	解剖部位
脑DWI	影像检查
置管术	手术
直肠腺癌（CT3NXM0）	疾病和诊断
静脉	解剖部位
SBC	实验室检验
TS-1 	药物
胃癌根治术（远端胃大切	手术
善宁	药物
肝S5、6段肝转移	疾病和诊断
阿托伐他汀钙	药物
前唇	解剖部位
静脉切开	药物
食道上段	解剖部位
维生素B12	实验室检验
胆囊切除＋胆总管探查＋Ｔ管引流术	手术
取胃	解剖部位
胸、腹部，CT	影像检查
锁骨下动脉斑块	疾病和诊断
胸膜增厚	疾病和诊断
合并腹水	疾病和诊断
转流术	手术
视神经	解剖部位
两侧肺门区	解剖部位
肝小囊肿	疾病和诊断
盆腔大量积液	疾病和诊断
右肺门淋巴结	解剖部位
右颈根	解剖部位
胰十二指肠切除术	手术
奈达铂	药物
卵巢粘液腺癌	疾病和诊断
右下肺叶斑片影，炎症	疾病和诊断
肠下皮化生	疾病和诊断
抗雄激素	药物
肝右叶内侧段	解剖部位
卵巢卵黄囊瘤	疾病和诊断
结肠腺癌（中低度分化）	疾病和诊断
两肺感染性病变	疾病和诊断
两上肺感染	疾病和诊断
肝脏转移瘤	疾病和诊断
鼻衄	疾病和诊断
(第9组)淋巴结	解剖部位
骶韧带	解剖部位
（直肠），：直肠溃疡型管状腺癌II级	疾病和诊断
双侧卵巢高位悬吊术	手术
直肠中上段	解剖部位
乳头状肿瘤	疾病和诊断
左髂总	解剖部位
右腋上淋巴结	解剖部位
椎体退行性变	疾病和诊断
CINIII级	疾病和诊断
肠区	解剖部位
（胃）低分化腺癌，弥漫浸润型	疾病和诊断
全子宫双附件切除术	手术
（胃角）腺癌	疾病和诊断
压氏达	药物
回盲部腺癌（中、低度分化）	疾病和诊断
动脉瘤破裂	疾病和诊断
心动过缓伴不齐	疾病和诊断
B超引导上经直肠前列腺穿刺活检	手术
胃低分化癌	疾病和诊断
十二指肠球炎	疾病和诊断
糖尿病视网膜病变	疾病和诊断
舒巴坦钠	药物
肩膀	解剖部位
早期食管癌（癌前病变）内镜上切除术	手术
气管右侧旁淋巴结	解剖部位
胞二磷胆碱	药物
血红蛋白	实验室检验
肠壁一站（4/10个）淋巴结	解剖部位
腹腔镜辅助上探查+直肠癌根治术	手术
溃疡中分化腺癌	疾病和诊断
升结肠肠乳头状管状腺癌II级	疾病和诊断
(喉返旁)淋巴结	解剖部位
胸椎、腰椎骨质增生	疾病和诊断
胃体管状腺癌	疾病和诊断
甘草合剂	药物
踝关节	解剖部位
肝转移低分化腺癌	疾病和诊断
食管中下段	解剖部位
直肠神经内分泌肿瘤	疾病和诊断
营养不良	疾病和诊断
右锁骨下、两侧腹股沟淋巴结	解剖部位
脾门	解剖部位
胸部+全腹部+盆腔CT	影像检查
S5段	解剖部位
行ERCP+胆管支架植入术	手术
恶性苗勒氏混合瘤	疾病和诊断
宫颈内口	解剖部位
腹腔镜辅助上根治性远端胃大部切除术	手术
大脑前、中、后动脉	解剖部位
宫颈CIN3改变累及腺体	疾病和诊断
良性前列腺增生	疾病和诊断
宫颈，浸润性低分化鳞癌	疾病和诊断
降结肠肿瘤	疾病和诊断
腹痛待查	疾病和诊断
左半结肠切除术+有附件切除术	手术
胆囊炎	疾病和诊断
肝癌＋胆囊切除	手术
左宫旁淋巴结	解剖部位
（第8组）淋巴结	解剖部位
静脉曲张	疾病和诊断
全膝关节置换	手术
全胃切除，空肠J字代胃术	手术
右腹股沟区	解剖部位
胸背	解剖部位
直肠癌肝转移术后化疗后	疾病和诊断
粪便隐血试验	实验室检验
总胆汁酸	疾病和诊断
右肺下叶中心型低分化鳞状细胞癌	疾病和诊断
直肠大体	解剖部位
右颧骨	解剖部位
(第1组）淋巴结	解剖部位
肝左前叶占位	疾病和诊断
(回结肠动脉根部)淋巴结	解剖部位
尼麦角林	药物
静脉吻合	解剖部位
肝门部胆管癌手术	手术
直肠癌并肝转移（CT4N+M1A）	疾病和诊断
(肠系膜上动脉)淋巴结	解剖部位
食管胸中上段癌	疾病和诊断
腹主动脉壁	解剖部位
脑水肿	疾病和诊断
CA242	实验室检验
肝被膜	解剖部位
羟考酮	药物
胃多发息肉	疾病和诊断
根治性膀胱切除＋回肠导管术	手术
门腔间隙淋巴结	解剖部位
左膈面	解剖部位
部分胃切除	手术
肝脏多发转移瘤	疾病和诊断
(下段食管旁)淋巴结	解剖部位
脑梗死后遗症	疾病和诊断
食道中段	解剖部位
甲强龙	药物
轻度ST段压低	疾病和诊断
主动脉钙化	疾病和诊断
门脉右支	解剖部位
直肠癌前切除术	手术
左卵巢高级别浆液性乳头状囊腺癌	疾病和诊断
胆汁酸	疾病和诊断
:食管粘膜慢性炎	疾病和诊断
血液系统疾病	疾病和诊断
胃底静脉曲张	疾病和诊断
长春胺缓释胶囊	药物
头颈部CTA	影像检查
回盲部腺癌术后	疾病和诊断
盆腔超声	影像检查
视盘水肿	疾病和诊断
CEA	实验室检验
头孢替安	药物
LAUREN，分型:弥漫型	疾病和诊断
（胃右动脉旁）淋巴结	解剖部位
拜复乐	药物
囊性病变	疾病和诊断
恶性肿瘤	疾病和诊断
胰头癌	疾病和诊断
胰岛素（空腹）	实验室检验
腹腔镜右半结肠切除术+DIXON术	手术
(回结结肠系膜肠系膜根部)淋巴结	解剖部位
上皮轻度异型增生	疾病和诊断
空腹末梢血糖	实验室检验
剖腹探查+结肠穿孔修补术	手术
不完全肠梗阻	疾病和诊断
乳房包块切除术	手术
胸中段食管癌	疾病和诊断
低分化癌转移	疾病和诊断
枕叶	解剖部位
右上腹部	解剖部位
胸腔积液	疾病和诊断
腹膜	解剖部位
炎性增生	疾病和诊断
臂前	解剖部位
两侧睾丸切除手术	手术
大隐静脉血栓形成	疾病和诊断
左侧腹股沟区	解剖部位
贲门上淋巴结	解剖部位
前列腺轻度增生并结	疾病和诊断
肾门部血管	解剖部位
肝左叶转移灶	疾病和诊断
升结肠癌术后	疾病和诊断
上腔静脉旁淋巴结	解剖部位
咽镜检查	手术
胃CA	疾病和诊断
胃腺癌	疾病和诊断
右侧髂总髂外	解剖部位
两肺底	解剖部位
肝转移胰腺实性-假乳头状瘤	疾病和诊断
回肠周淋巴结	解剖部位
肝左叶肝癌切除+胆囊切除术	手术
双侧子宫动脉造影	手术
粘连性肠梗阻	疾病和诊断
单克	药物
壶腹周围恶性肿瘤术后	疾病和诊断
内镜上息肉切除术	手术
氨茶碱缓释片	药物
5-FU	药物
胃癌姑息性切除术	手术
肝、肺、骨多发转移	疾病和诊断
部分胞浆	解剖部位
胃癌远端胃切除术后	疾病和诊断
左半结肠切除术、胃肠吻合术	手术
胸部外伤	疾病和诊断
直肠中分化腺癌（T4N0M0IIB期）	疾病和诊断
结肠中分化腺癌	疾病和诊断
乳腺癌根治	手术
脾功能亢进症	疾病和诊断
前胸	解剖部位
胃神经内分泌癌术后	疾病和诊断
腹盆B超	影像检查
右髂总及左髂总淋巴结	解剖部位
宫颈冷刀锥切术	手术
头CT	影像检查
（左喉返喉返神经神经旁）淋巴结	解剖部位
六组（2/9个）淋巴结	解剖部位
早期食管癌	疾病和诊断
全腹CT+增强	影像检查
（第15组）淋巴结	解剖部位
肝S6、7	解剖部位
上肢彩超	影像检查
第12组淋巴结	解剖部位
复方地茯口服液	药物
右乳头	解剖部位
诺和锐	药物
舒坦	药物
肝部分切除及胆囊切除术	手术
优思林	药物
左梨状窝鳞癌	疾病和诊断
肝细胞肝癌	疾病和诊断
酮体	实验室检验
喉	解剖部位
心功能不全	疾病和诊断
隆突上见淋巴结	解剖部位
右上肢静脉曲张伴溃疡感染	疾病和诊断
结肠腺管状腺瘤	疾病和诊断
谷草转氨酶	实验室检验
右股骨肌腱附着处	解剖部位
根治性膀胱切除术+回肠原位新膀胱术	疾病和诊断
结肠息肉术后	疾病和诊断
电凝切除	手术
TP	实验室检验
食管胃交界溃疡型低分化腺癌	疾病和诊断
胆	解剖部位
中叶支气管	解剖部位
口疮	疾病和诊断
经腹子宫切除术	手术
TEM术	手术
复方黄松洗液	药物
抑制剂	药物
心脏起搏器植入术	手术
胰腺体部及尾部	解剖部位
盲肠	解剖部位
肾小结石	疾病和诊断
胃底升结肠印戒细胞癌	疾病和诊断
子宫内膜分段诊刮	手术
左侧腹腔	解剖部位
胸部CT	影像检查
直肠占位	疾病和诊断
谷胱甘肽	药物
LAR手术	手术
两肾	解剖部位
胃肠吻合术	手术
鳞状细胞癌转移	疾病和诊断
胃角巨大胃溃疡	疾病和诊断
横结肠癌	疾病和诊断
（子宫）低分化鳞状细胞癌	疾病和诊断
两侧盆腔	解剖部位
腺鳞癌	疾病和诊断
腹腔镜探查术	手术
艾恒	药物
腹盆CT	影像检查
左上腹	解剖部位
胰头占位WIPPLE术后	疾病和诊断
雷贝拉唑	药物
C肽（空腹）	实验室检验
胸膜	解剖部位
直肠多发息肉切除术	手术
感染性休克	疾病和诊断
腹腔镜上根治性远端胃大部切除术	手术
胰头中低分化腺癌	疾病和诊断
腹部彩超	影像检查
大弯淋巴结	解剖部位
IBIL	实验室检验
上肢静脉	解剖部位
胃窦溃疡溃疡型中分化腺癌	疾病和诊断
肝S3转移	疾病和诊断
肝脏表面	解剖部位
CYFRA21-1	实验室检验
高至中分化腺癌	疾病和诊断
左侧下肢	解剖部位
腰背	解剖部位
红细胞体积分布宽度	实验室检验
淋巴结8/17见转移	疾病和诊断
空肠回肠侧侧吻合术	手术
腹内斜肌	解剖部位
舒巴坦	药物
腹腔镜上直乙交界处结肠癌根治术	手术
两侧卵巢	解剖部位
肠壁外膜层	解剖部位
C225	药物
周围软组织	解剖部位
S1	药物
主动脉窗	解剖部位
羟基尿	药物
直肠、乙状结肠息肉	疾病和诊断
（子宫）中至低分化子宫内膜样腺癌	疾病和诊断
十二指肠粘膜上层	解剖部位
总胆红素 	实验室检验
阴道顶端切口出血伴感染	疾病和诊断
第7、8组淋巴结	解剖部位
大脑前动脉	解剖部位
海马	解剖部位
胃CA侵出浆膜层并网膜种植转移	疾病和诊断
肠壁二站（3个）淋巴结	解剖部位
右枕叶脑出血	疾病和诊断
食管乳头状瘤”胃镜上切除	手术
全身肌肉关节	解剖部位
左侧附件区	解剖部位
（胃）中低分化腺癌，溃疡型	疾病和诊断
紫杉醇脂质体	药物
内壁	解剖部位
回盲部	解剖部位
（左侧）卵巢	解剖部位
产科	解剖部位
左房	解剖部位
食管息肉	疾病和诊断
腹股沟区	解剖部位
经腹全子宫切除术+两侧附件切除术	手术
左肺中叶	疾病和诊断
溃疡型低分化腺癌	疾病和诊断
右颈肿大淋巴结穿刺活检术	手术
（子宫）高级别恶性肿瘤	疾病和诊断
神经内分泌肿瘤	疾病和诊断
肝部分切除术后	疾病和诊断
腹腔	解剖部位
贲门溃疡，	疾病和诊断
左下肺肿物	疾病和诊断
特罗凯	药物
肠系膜上动脉根部	解剖部位
右侧胸	解剖部位
幽门梗阻	疾病和诊断
腹腔积液（少量）	疾病和诊断
左半结肠切除+淋巴结清扫术	手术
肺部CT	影像检查
草酸铂	药物
尿素	实验室检验
(肠系膜上A根部）淋巴结	解剖部位
胸、，下腹部CT	影像检查
右侧胸膜	解剖部位
安斯菲	药物
网膜	解剖部位
全子宫两附件切除+盆腔粘连松解术	手术
肝内外胆管结石伴急性胆管炎	疾病和诊断
慢性膀胱炎	疾病和诊断
右肺上叶背段病变穿刺活检+微波消融术	手术
腹膜种植转移	疾病和诊断
腹膜反折下2CM处直肠	解剖部位
胃癌根治术	手术
CA-125	实验室检验
左足第三趾	解剖部位
下丘	解剖部位
全膀胱切除根治术+回肠导管术	手术
力扑素	药物
白蛋白	实验室检验
阑尾粘膜慢性炎	疾病和诊断
化痰中药	药物
矽肺	疾病和诊断
右侧额顶叶	解剖部位
PaO2	实验室检验
颈胸腹部，CT	影像检查
直肠癌伴肝转移化疗后术后	疾病和诊断
后肠	解剖部位
左人工股骨头置换术	手术
（宫颈）恶性肿瘤	疾病和诊断
子宫底	解剖部位
肝S6	解剖部位
胆管	解剖部位
肝门静脉	解剖部位
胃角癌	疾病和诊断
姑息性胰十二指肠切除术	手术
钠	实验室检验
增强MR	影像检查
右上肢浅表血管	解剖部位
（右附件）卵巢浆液性乳头状囊腺癌	疾病和诊断
盐酸羟考酮	药物
十二指肠乳头中分化腺癌	疾病和诊断
门静脉主干	解剖部位
胸腹盆CT	影像检查
阴道镜检查+宫颈活检	手术
肠系膜及网膜癌转移	疾病和诊断
头部	解剖部位
腹腔镜辅助上姑息性右半结肠切除术	手术
活化部分凝血活酶时间	实验室检验
宫	解剖部位
中下腹部	解剖部位
中度脂肪肝	疾病和诊断
透皮贴剂	药物
直肠癌（T3期）	疾病和诊断
右半结肠	解剖部位
肝左后叶上段及两肾囊肿	疾病和诊断
升结肠中分化腺癌	疾病和诊断
双侧输卵管卵巢切除术	手术
肝脏多发转移	疾病和诊断
面部肌肉	解剖部位
直肠癌根治	疾病和诊断
肝MT	疾病和诊断
十二指肠粘膜	解剖部位
盆腔炎性疾	疾病和诊断
右上肢静脉曲张	疾病和诊断
格列齐特	药物
食管CA	疾病和诊断
频发多源室性早搏	疾病和诊断
淋巴细胞百分比	实验室检验