替加氟胶囊	药物
消旋卡多曲	药物
肝康颗粒	药物
噻乙啶	药物
阿替普酶	药物
羊水中回声增强增多	症状
疤痕止痒软化乳膏	药物
秋裂胺	药物
阿昔洛韦缓释片	药物
司坦唑醇片	药物
维生素EC颗粒	药物
缺乏性的兴趣和性活动的要求	症状
氧化再生纤维素	药物
红鹿参片	药物
藿香祛暑水	药物
盐酸环丙沙星	药物
高热寒战	症状
对乙酰氨基酚干混悬剂	药物
乳泉冲剂	药物
盐酸黄连素	药物
马尿酸乌洛托品	药物
九味羌活片	药物
骨刺片	药物
骨旁骨肉瘤	疾病
血清铜氧化酶吸光度降低	症状
颅内生殖细胞瘤	疾病
鲜天麻胶囊	药物
甲苯磺丁脲	药物
预激综合征	疾病
芩石利咽口服液	药物
小儿郎格罕细胞性组织细胞增生症	疾病
妇女咳嗽性遗尿	疾病
熊胆川贝口服液	药物
情绪性失眠	症状
十滴水胶丸	药物
羟考酮	药物
偻附	疾病
脑结核瘤	疾病
解热清肺糖浆	药物
立体几何	NoneType
胸壁软组织畸形	疾病
小脑体征	症状
尿沉渣管型检查	检查科目
妇科回生丸	药物
冻干静注人免疫球蛋白	药物
降气定喘丸	药物
妇科炎症	疾病
西米替丁胶囊	药物
氯米芬	药物
呋苄西林	药物
盐酸吡格列酮口腔崩解片	药物
硬化	症状
科达琳	药物
肝内管梗阻	症状
维生素D3	药物
酚酞	药物
抬肩以助呼吸	症状
变性球蛋白(Heinz)小体染色试验	检查科目
凹陷瘢痕	症状
下肢肌肉瘫痪	症状
安神补脑口服液	药物
酚磺乙胺	药物
棘形红细胞	检查科目
依降钙素注射液	药物
抗内膜抗体阳性	症状
五味通栓口服液	药物
番茄不孕病毒	病毒
咽反射亢进	症状
枫蓼肠胃康合剂	药物
藏毛性疾病	疾病
消肿痔疮片	药物
太阳中风	疾病
红球菌属	细菌
蛇床子	药物
前列康片	药物
富马酸异哌丙吡胺片	药物
武力拔寒散	药物
心肌灰白而松弛	症状
门多萨假单胞菌	细菌
乳头状汗腺腺瘤	疾病
人促甲状腺素免疫放射分析药盒	药物
莫米松	药物
苯丙酸诺龙注射液	药物
乳泉颗粒	药物
体质	NoneType
附件炎	疾病
消食退热糖浆	药物
克汀病面容	症状
保泰松片	药物
催乳素	药物
红细胞生成素	检查科目
裂头蚴病	疾病
已烯雌酚片	药物
环匹酮胺	药物
通络生骨胶囊	药物
津力达颗粒	药物
铁线虫病	疾病
胃溃疡	疾病
妊娠期急性脂肪肝	疾病
子宫颈变大	症状
食管气管瘘	症状
黄曲霉素中毒	疾病
月见草油胶丸	药物
糖尿病所致脊髓病	疾病
角膜老年环	疾病
阴茎阴囊象皮肿	疾病
控涎丸	药物
养心达瓦依米西克蜜膏	药物
脑脊液细胞分类计数	检查科目
肱骨远端全骨骺分离	疾病
白消安片	药物
老年人病态窦房结综合征	疾病
色羟丙钠滴眼液	药物
食管闭锁	症状
女珍颗粒	药物
普罗瑞林	药物
高雄激素血症	症状
桑菊感冒丸	药物
外阴淋巴管瘤	疾病
躯干畸形弯曲	症状
注射用头孢唑啉钠	药物
绿尾大蚕蛾核多角体病毒	病毒
下肢淋巴水肿	疾病
骨髓抑制	症状
硫酸镁溶液	药物
病理性赌博	症状
老年人梅毒性心脏病	疾病
法莫替丁胶囊	药物
雷贝拉唑钠肠溶片	药物
紫绀和血缺氧	症状
双藤筋骨片	药物
冰黄软膏	药物
糖尿病足	疾病
多烯磷脂酰胆碱	药物
盘状红斑	症状
甲状腺球蛋白抗体放免药盒	药物
环丙孕酮	药物
红细胞畸形	症状
蠲痹抗生丸	药物
赛空青眼药	药物
血虚眩晕	疾病
注射用鲑鱼降钙素	药物
诺氟沙星软膏	药物
杷叶润肺止咳膏	药物
健胃消食颗粒	药物
注射用去水卫矛醇	药物
重组人血小板生成素注射液	药物
硝苯地平胶丸	药物
四君子丸	药物
联苯苄唑凝胶	药物
头孢氨苄	药物
脑脊液异柠檬酸脱氢酶	检查科目
喉纤维瘤	疾病
双羊喉痹通颗粒	药物
皮上划痕人用布氏菌活疫苗	药物
子痫	疾病
金水宝片	药物
肺弓形体病	疾病
里急后重	症状
骨剌消痛胶囊	药物
膀胱平滑肌瘤	疾病
杏苏合剂	药物
特非那丁胶囊	药物
锁阳固精丸	药物
对乙酰氨基酚滴剂	药物
转化糖电解质注射液	药物
先兆早产	疾病
左氧氟沙星注射液	药物
喉水肿	疾病
蝌蚪	NoneType
谢健青定论	NoneType
止咳桃花散	药物
双分伪麻片(成人片)	药物
流鼻涕	症状
红草止鼾颗粒	药物
马来酸替加色罗胶囊	药物
粒细胞与红细胞比值	检查科目
胎儿生长受限	疾病
上巩膜静脉压升高所致青光眼	疾病
头皮平直裂口	症状
五味渣驯胶囊	药物
苦碟子注射液	药物
晶状体囊壁破裂	症状
银龙清肝片	药物
Zieve综合征	疾病
尿素清除率(UCL)	检查科目
外伤后低颅压综合征	疾病
先天性肝内胆管囊状扩张症	疾病
复方淀粉酶口服溶液	药物
注射用复方甘草酸苷	药物
盐酸羟甲唑啉	药物
感冒解热冲剂	药物
静脉出血	症状
风寒双离拐片	药物
维银翘片	药物
先天性喉软化症	疾病
维生素D缺乏神经病	疾病
难产	疾病
右旋糖酐20葡萄糖注射液	药物
丹七片	药物
左氧氟沙星片	药物
清热解毒片	药物
复方蒲芩胶囊	药物
下颌下间隙感染	疾病
妇炎康复颗粒	药物
栓灵胶囊	药物
尿液颜色	检查科目
隐性水肿	症状
异福片	药物
急性子宫内膜炎	疾病
头孢羟氨苄甲氧苄啶胶囊	药物
氢溴酸山莨菪碱	药物
心房内形成混合血	症状
养血荣筋丸	药物
芽孢杆菌	细菌
白金丸	药物
椎体严重楔形变并伴小关节半脱位	疾病
琥乙红霉素口腔崩解片	药物
上肢及面部血管曲张、水肿及青紫	症状
血管壁及周围有Ig及补体沉着	症状
胃尔宁片	药物
利胆止痛片	药物
蔗糖-异麦芽糖吸收不良	症状
苯甲酸	药物
嗜心性病毒感染	症状
面部偏侧萎缩	疾病
长春胺缓释胶囊	药物
先天性再生障碍性贫血	疾病
腕关节结核	疾病
盐酸加替沙星胶囊	药物
澳泰乐颗粒	药物
注射用叶酸	药物
诺氟沙星乳膏	药物
灭癌素链霉菌	细菌
新型冠状病毒感染的肺炎诊疗方案	NoneType
注射用盐酸表柔比星	药物
丹皮酚贴膏	药物
甲硝唑口颊片	药物
克霉唑	药物
益津降糖颗粒	药物
毛囊性鱼鳞病	疾病
维生素E	药物
足趾痛	症状
腰部僵硬及腰前凸消失	症状
曲匹布通	药物
创伤性鼻中隔穿孔	疾病
痰喘片	药物
枣参合剂	药物
巴柳氮钠胶囊	药物
卡溴脲	药物
沉香化气胶囊	药物
大量元素	NoneType
血清钙	检查科目
单纯性紫癜	疾病
髌骨脱位	疾病
盐酸司他斯汀	药物
聚乙二醇4000散剂	药物
多囊卵巢	症状
克拉霉素缓释片	药物
干燥斑	症状
怪笑	症状
冻干人乙型肝炎免疫球蛋白	药物
羊水过多	疾病
高脂蛋白血症Ⅳ型	疾病
猪胆粉薄荷脑软膏	药物
甲状旁腺骨营养不良	疾病
复方熊胆滴眼液	药物
重组牛碱性成纤维细胞生长因子(融合蛋白)眼用凝胶	药物
颌骨内似牙的硬组织	症状
出血性丘疹	症状
睡觉时心跳加快	症状
股骨头骨折	疾病
气压伤	疾病
放射性肾炎	疾病
非溃疡消化不良	疾病
急性胆源性胰腺炎	疾病
强肝糖浆	药物
地奈德	药物
抗感解毒口服液	药物
棘阿米巴性巩膜炎	疾病
先天性食管狭窄	疾病
甲氯芬酯	药物
补肾健脾口服液	药物
低蛋白血症	症状
加巴喷丁胶囊	药物
蒲公英胶囊	药物
南通蛇药	药物
氯氧喹胶囊	药物
细菌性肠炎	疾病
右旋糖酐铁口服液	药物
云实感冒合剂	药物
己二烯雌酚片	药物
结、直肠黑变病	疾病
碳酸钙二甲硅油咀嚼片	药物
动脉栓塞	疾病
妊娠合并消化性溃疡	疾病
东山感冒片	药物
环咽部运动障碍	症状
复方福尔可定口服液	药物
复方羊肝丸	药物
肺血流量很多	症状
输卵管妊娠	疾病
羊痫疯癫丸	药物
股骨髁骨折	疾病
眼白出现红点	症状
小儿维生素B2缺乏病	疾病
口腔粘膜弥漫充血	症状
九制大黄丸	药物
冻疮	疾病
颅骨骨髓炎	疾病
垂体性矮小病	疾病
小儿止泻安冲剂	药物
辛夷鼻炎丸	药物
阿魏化痞膏	药物
下肢神经性疼痛	症状
巨大膀胱	症状
血型不完全抗体检测卡	药物
氯己定苯佐卡因含片	药物
高腭弓	症状
期外收缩	症状
孔圣枕中丸	药物
维生素D2丸	药物
焦虑	症状
打嗝	症状
红细胞醛缩酶	检查科目
反复上呼吸道感染	症状
注射用盐酸拉贝洛尔	药物
春季性结膜炎	疾病
西红花总苷片	药物
莲必治注射液	药物
往来寒热	疾病
小儿室间隔缺损	疾病
焦痂性烧伤	症状
冰七片	药物
复方卡力孜然酊	药物
复方鱼腥草合剂	药物
银杏叶丸	药物
心肌炎	疾病
筛窦恶性肿瘤	疾病
消淋败毒丸	药物
人IgE酶标诊断试剂盒	药物
血管畸形引起的吞咽困难	疾病
肾骨散	药物
冻疮消酊	药物
清热疏肝口服液	药物
氯贝丁酯胶囊	药物
息喘丸	药物
参蛤平喘胶囊	药物
复方阿嗪米特肠溶片	药物
肝纤维化	疾病
柴贯解热颗粒	药物
抗体免疫缺陷病	疾病
金酸萍糖浆	药物
A群轮状病毒诊断试剂盒(胶体金法)	药物
鼻炎片	药物
氨酪酸	药物
成人腹股沟斜疝	疾病
人类免疫缺陷病毒抗体HIV1/2/O诊断试剂盒酶联免疫法	药物
处女膜闭锁	疾病
慢脾风	疾病
生产销售伪劣产品罪	NoneType
食管梗阻	症状
生脉袋泡茶	药物
八味安宁散	药物
一扫光药膏	药物
参芪健胃颗粒	药物
尿道与阴茎结核	疾病
参柏舒阴洗液	药物
复方碳酸氢钠颠茄胶囊	药物
益气复脉颗粒	药物
臀肌挛缩症	疾病
伤口愈合发痒	症状
月光宝鹏丸	药物
十复生胶囊	药物
老年人胆石症	疾病
蜂胶牙泰	药物
不规则热	症状
生长过快	症状
溴莫尼定	药物
追风片	药物
乳癖康片	药物
新霉素软膏	药物
凹甲	症状
上海精神医学	NoneType
格拉非宁	药物
小儿病毒相关吞噬血细胞综合征	疾病
甘草酸A	药物
胶原酶溶液	药物
硝呋替莫	药物
小儿清热止咳合剂	药物
联苯双酯胶囊	药物
复方硝酸戊四醇酯片	药物
扎莫特罗	药物
戈谢病	疾病
男子乳腺发育	疾病
视野向心性缩小	症状
嗜异性凝集试验	检查科目
阿奇霉素肠溶片	药物
传染性单核细胞增多症	疾病
网状青斑和坏疽	症状
碳酸氢钠注射液	药物
急性酒中毒	疾病
硫酸钠	药物
鼻黏膜和鼻甲萎缩	症状
双吸气	症状
老年人急性胰腺炎	疾病
颈动脉盗血综合征	疾病
婴儿健脾胶囊	药物
金羚感冒胶囊	药物
上颌窦后鼻孔息肉	疾病
经舒颗粒	药物
克罗恩病	疾病
复方骆驼蓬子软膏	药物
H7n7	疾病
盐酸羟苄唑滴眼液	药物
心源性呼吸窘迫	症状
睑结膜出现灰白色膜	症状
青龙蛇药片	药物
噪声病	疾病
隐匿阴茎	疾病
妊娠合并生殖道沙眼衣原体感染	疾病
毕赤酵母	细菌
高乌甲素	药物
生脉片	药物
阿魏八味丸	药物
复方炉甘石外用散	药物
银密片	药物
小金片	药物
辛酸纳	药物
尿微量白蛋白定量测定试剂盒(酶联免疫法)	药物
瘰疬性苔藓	疾病
脉管炎	疾病
面下部头痛	症状
沙眼衣原体肺炎	疾病
胎宝胶囊	药物
胃液尿素测定	检查科目
柴胡滴丸	药物
皮下脂质肉芽肿病	疾病
肩-手综合征	疾病
酮康他索乳膏	药物
甲氨蝶呤片	药物
乳酸左氧氟沙星氯化钠注射液	药物
复方芦荟胶囊	药物
痘疮	症状
九味羌活颗粒	药物
盐酸氯米帕明片	药物
外阴阿米巴病	疾病
野木瓜片	药物
心包破损伤	症状
外斜A征	症状
婴儿平	药物
乙型肝炎病毒表面抗体诊断试剂盒	药物
食管出血	症状
瑞尔黑变病	疾病
腹壁广泛性钙质沉着	症状
小儿急性胆囊炎	疾病
匍行性血管瘤	疾病
茵陈五疸丸	药物
子囊菌	NoneType
口炎清颗粒	药物
中耳气压伤	疾病
枸橼酸铝	药物
柴胡注射剂	药物
外阴疖病	疾病
老人腹股沟斜疝	疾病
布洛伪麻缓释胶囊	药物
高颅压综合征	症状
茵陈五苓丸	药物
福辛普利	药物
关节液中白细胞内有尿酸结晶	症状
奥美拉唑肠溶胶囊	药物
阑尾壁缺血坏死	症状
脱皮	症状
经期推迟	症状
上肢外展上举困难	症状
气微菌属	细菌
口角肌肉的抽搐	症状
53蛋白	检查科目
治感灵冲剂	药物
香荷止痒软膏	药物
马来酸氯苯那敏	药物
宁嗽化痰丸	药物
景天祛斑胶囊	药物
消渴降糖片	药物
小儿定喘口服液	药物
复方新霉素软膏	药物
晕厥预兆	症状
加味归芪片	药物
尿早早孕试验	检查科目
盐酸博安霉素	药物
类诺卡氏菌属	细菌
复方多维元素片	药物
精索恶性肿瘤	疾病
皮肤老化	症状
盐酸倍他司汀注射液	药物
更昔洛韦眼用凝胶	药物
胃肠积液	疾病
天麻头风灵咀嚼片	药物
胰酶片	药物
金莲清热颗粒	药物
肺炎链球菌性肺炎	疾病
蛛网膜囊肿	疾病
静脉血栓	症状
盐类皮质激素分泌过多	症状
股沟及大腿内侧皮肤有色素沉积	症状
扑尔伪麻片	药物
脑血管动静脉畸形	症状
缺铁性贫血	疾病
肌肉跳动	症状
进行性肢端黑变病	疾病
腰大肌阴影消失	症状
小柴胡汤丸	药物
耳屎多	症状
气球状细胞痣	疾病
愈酚伪麻待因口服溶液	药物
颅内黑色素瘤	疾病
醋酸甲羟孕酮复合胶囊	药物
天麻头风灵胶囊	药物
精索增粗肿胀	症状
樱桃状血管瘤	疾病
消咳胶囊	药物
棕榈哌泊塞嗪注射液	药物
维生素A中毒症	疾病
三氟丙嗪	药物
大麻隆	药物
气性膀胱炎	疾病
噫气	疾病
皮下T细胞淋巴瘤	疾病
诺氟沙星	药物
罗浮山风湿膏药	药物
榄香烯口服乳	药物
淹溺	疾病
维生素C泡腾片	药物
小儿盐酸小檗碱丸	药物
肌肉砸伤	症状
臀沟下垂状跛行步态	症状
心房游走性节律	症状
醋氯芬酸肠溶胶囊	药物
利巴韦林含片	药物
嗄日迪五味丸	药物
艾司洛尔	药物
乳痛症	症状
强骨胶囊	药物
仙鹿补酒	药物
去水卫矛醇	药物
思维不连贯	症状
结节性筋膜炎	疾病
醋酸钙颗粒	药物
直肠狭窄	症状
茸术口服液	药物
胶原	药物
朝阳丸	药物
精瘀证	疾病
肛肠息肉	疾病
二丁胶囊	药物
北京体检中心	NoneType
卵泡发育不良	疾病
腱鞘巨细胞瘤	疾病
复方儿茶胶囊	药物
甲亢眼突	疾病
衰弱	症状
巴洛沙星	药物
上肢半屈状	症状
小儿阿姆斯特丹型侏儒	疾病
劳累时腰部酸痛或胀痛	症状
白喉棒杆菌	细菌
夹层血肿	症状
脉络膜出血	疾病
二巯丁二钠	药物
小儿吐泻宁	药物
替哨唑片	药物
钩端螺旋体补体结合试验	检查科目
金银花口服液	药物
梅克尔憩室	疾病
原发性硬化性胆管炎	疾病
吲哚洛尔	药物
眼底樱桃红斑	症状
武汉市金银潭医院	NoneType
盐酸赖氨酸片	药物
注射用硫酸卷曲霉素	药物
特异性肾实质疾病	疾病
输尿管间脊肥大	症状
复方甘油溶液	药物
转换性障碍	疾病
肝阴虚	症状
盐酸倍他洛尔滴眼液	药物
光反射消失	症状
“咳嗽水”上瘾	症状
活动盲肠综合征	疾病
甲乙哌酮	药物
地巴唑片	药物
鼻渊丸	药物
沙眼衣原体IgM和IgG	检查科目
腓肠肌撕裂	症状
消疲灵颗粒	药物
注射用重组人粒细胞集落刺激因子	药物
寻常疣	疾病
注射用盐酸地尔硫卓	药物
对乙酰氨基酚溶液	药物
眼眶平滑肌瘤	疾病
包头市传染病防治条例	NoneType
野苏颗粒	药物
罗格列酮片	药物
黄瓜花叶病毒	病毒
老年性皮肤萎缩	疾病
培哚普利	药物
九味獐牙菜丸	药物
人格改变	症状
下肢呈剪刀步态	症状
调经益灵片	药物
阿膜散	药物
麝香关节止痛膏	药物
羊胡疮	疾病
阿德福韦酯片	药物
芪胶升白胶囊	药物
痛肿灵	药物
注射用已酮可可碱	药物
注射用盐酸普鲁卡因	药物
婴儿保肺宁	药物
营养代谢疾病伴发的精神障碍	疾病
药物性肝病	疾病
代偿性多汗症	疾病
低分子羟乙基淀粉	药物
睑皮松垂症	疾病
丙酮酸激酶缺乏症	疾病
万通筋骨片	药物
蟾蜍分枝杆菌	NoneType
复方硫黄乳膏	药物
胆囊壁变薄	症状
寒性体质	症状
导肠粒	药物
金薯叶止血合剂	药物
外阴神经鞘瘤	疾病
膦甲酸钠氯化钠注射液	药物
游离甲状腺指数	检查科目
头霉素C	药物
小儿原发性肾病综合征	疾病
停经过早	症状
口服双歧杆菌乳杆菌嗜热链球菌三联活菌片	药物
香砂养胃片	药物
环丙贝特	药物
原藻病	疾病
老年人主动脉夹层分离	疾病
柘木糖浆	药物
板蓝根泡腾片	药物
耻骨联合分离	症状
南板蓝根颗粒	药物
止痛水	药物
瑞香素	药物
眼裂细小	症状
泪液表皮生长因子	检查科目
注射用更昔洛韦	药物
乳酶生片	药物
蔗尘肺	疾病
流黄鼻涕	症状
万应颗粒	药物
尘螨过敏性哮喘	疾病
食管重复	症状
参龙补肾胶囊	药物
青藤风湿酒	药物
玻璃纤维引起的皮肤病	疾病
四环素	药物
抗甲状腺过氧化物酶抗体	检查科目
白蚀丸	药物
注射用硫喷妥钠	药物
海菊颗粒	药物
尿酸化异常	症状
小儿肠吸收不良综合征	疾病
周期性嗜睡强食症	症状
感冒解毒灵颗粒	药物
肠鸣音消失	症状
迪格奥尔格综合征	疾病
泻痢固肠片	药物
颈静脉充盈	症状
链霉菌属	细菌
甲苯磺酸妥舒沙星	药物
厌奶	症状
果汁维生素C片	药物
晶状体移位	症状
马链球菌	细菌
丹膝颗粒	药物
复方田七胃痛片	药物
维生素B1注射液	药物
白癜风胶囊	药物
肛康穆库利片	药物
双醋炔诺醇	药物
健脾五味丸	药物
新生儿水肿	疾病
心脏直视手术所致神经疾病	疾病
苦参总碱	药物
槐杞黄颗粒	药物
跟骨骨骺骨软骨病	疾病
中心性浆液性脉络膜视网膜病变	疾病
非依赖性物质伴发依赖	疾病
阿咖酚胶囊	药物
复方银翘氨酚维C片	药物
脑脉利颗粒	药物
昆明山海棠片	药物
血管网织细胞瘤	疾病
去氧皮质酮	药物
眶蜂窝织炎	疾病
回生第一丹	药物
胞磷胆碱钠胶囊	药物
保胎无忧散	药物
肾小管性酸中毒	疾病
格林－巴利综合征	疾病
氨愈美麻片	药物
肺炎支原体寒冷凝集试验	检查科目
精液不液化	疾病
家蚕核多角体病毒 SC株	病毒
盐酸半胱氨酸甲酯	药物
心瓣膜穿孔	症状
艽龙胶囊	药物
牙内吸收	疾病
美吡拉敏	药物
肺血吸虫病	疾病
双氯芬酸二乙胺乳胶剂	药物
苯磺酸左旋氨氯地平	药物
杏仁腈溶液	药物
亚硝酸异戊酯吸入剂	药物
绿雪	药物
复方氯己定达克罗宁乳膏	药物
食母生片	药物
活血通脉胶囊	药物
来曲唑	药物
琥珀酸亚铁	药物
阿奇霉素颗粒剂	药物
不排胎便	症状
硬脑膜外和硬脑膜下脓肿	疾病
丙型肝炎病毒抗体免疫球蛋白M	检查科目
注射用盐酸艾司洛尔	药物
强力枇杷露(炼蜜)	药物
重度精神发育迟滞	症状
苔藓样结核疹	疾病
复方五仁醇胶囊	药物
鼠疫菌诊断血清	药物
腘动脉损伤	疾病
痴呆综合征	疾病
药用灸条	药物
止嗽片	药物
更昔洛韦钠氯化钠注射液	药物
乌拉地尔缓释片	药物
开郁老蔻丸	药物
复方炔雌醇片	药物
扁平苔癣	疾病
一咳嗽胸口就疼	症状
肺炎衣原体肺炎	疾病
皮肤温度升高	症状
小儿多发性内分泌腺瘤Ⅱ型	疾病
醋杆菌	细菌
结石通片	药物
肥儿宝冲剂	药物
儿康宁糖浆	药物
黄酮哌酯	药物
川贝枇杷片	药物
皮肤肿瘤	疾病
衣鞘	NoneType
小儿至宝丸	药物
右旋糖酐40氯化钠注射液	药物
消石利胆胶囊	药物
卵巢卵黄囊瘤	疾病
注射用甲钴胺	药物
肺疝	疾病
解表清金散	药物
括约肌功能障碍	症状
复方陈香胃片	药物
杜鹃素	药物
注射用核糖核酸	药物
脑安胶囊	药物
食滞胃脘主证	疾病
婴儿褐色或暗绿色的粘液便	症状
引阳索片	药物
云南白药创可贴	药物
小脑出血	症状
双梅喉片	药物
耳部恶性肿瘤	疾病
特发性震颤	疾病
辛伐他汀分散片	药物
硫酸依替米星注射液	药物
沙丁胺醇口腔崩解片	药物
马杜拉放线菌	细菌
低分子量肝素钠	药物
长时间或剧烈运动后前足疼痛	症状
盐酸多巴酚丁胺	药物
催产素	检查科目
药物性耳聋	疾病
甘氨酰脯氨酸二肽氨基肽酶	检查科目
朝阳胶囊	药物
长碳链脂肪酸	检查科目
表皮痣	疾病
手术后膈疝	疾病
舒心口服液	药物
金骨莲胶囊	药物
盐酸依匹斯汀片	药物
痰液中细胞分类	检查科目
冻干人凝血酶	药物
阵发性子宫收缩	症状
咳舒糖浆	药物
脂肪代谢障碍	症状
皮肤弹性差	症状
碘苷	药物
清咽抑火丸	药物
子宫内翻	疾病
冬凌草糖浆	药物
游离甲状腺素	检查科目
注射用果糖二磷酸钠	药物
盐酸多塞平片	药物
胆汁淤滞	症状
乌鸡养血糖浆	药物
二硫化硒	药物
妊娠期高血压	症状
肺性肥大	症状
口腔黏膜嗜酸性溃疡	疾病
乙型肝炎病毒表面抗原血清胶体金试纸条	药物
磷酸甘油转化酶	检查科目
前列地尔注射液	药物
曲美孕酮	药物
丁酸梭菌	细菌
磷酸川芎嗪滴丸	药物
巨脚	症状
益胆片	药物
乳癖散结胶囊	药物
牛黄西羚丸	药物
焦楂化滞丸	药物
地蒽酚蜡棒	药物
黏多糖贮积症Ⅰ型	疾病
产后风	疾病
慢性自律性房性心动过速	疾病
比沙可啶片	药物
伤痛宁胶囊	药物
维磷葡钙片	药物
阿尔维林	药物
耆鹿逐痹胶囊	药物
利福平胶囊	药物
指甲床发绀	症状
感冒灵胶囊	药物
西地那非	药物
酵母菌	NoneType
下肢感应痛或放射痛的腰背痛	症状
周围神经病损	疾病
伏格特-小柳-原田综合征	疾病
食物过敏	症状
氟米龙滴眼液	药物
氢溴酸西酞普兰	药物
急性脑内血肿	疾病
妥布霉素氯化钠注射液	药物
乳头内陷	疾病
拉坦前列素	药物
糜木瓜酶	药物
盐酸氨溴索糖浆	药物
盐酸丙卡特罗	药物
骨肉瘤	疾病
褐黄病	疾病
注射针眼和手术切口出血	症状
小儿麻疹	疾病
颌突畸形	症状
精囊增大	症状
注射用盐酸博来霉素	药物
奋乃静注射液	药物
西瓦特皮肤异色病	疾病
眶周瘀斑	症状
硫酸氯吡格雷	药物
秦归活络口服液	药物
注射用亚锡葡萄糖酸钙	药物
早孕反应	疾病
维胺酯胶丸	药物
盐酸左旋咪唑	药物
穿心莲片	药物
乳头溢出血性或棕色浆液性液体	症状
甘氯林气雾剂	药物
婴幼儿脐疝	疾病
甲型肝炎抗原	检查科目
缩泉丸	药物
乳腺肥大	症状
食管其他恶性肿瘤	疾病
姜颗粒	药物
琥珀酸舒马普坦胶囊	药物
氢溴酸烯丙吗啡注射液	药物
复方松醇那敏片	药物
慢支固本颗粒	药物
指甲末端呈直线形	症状
骨肿瘤	疾病
髋关节后脱位	疾病
风洞	NoneType
蜂胶牙痛酊	药物
老年性眩晕	症状
羚珠散	药物
葛芪胶囊	药物
唇水疱	症状
脂溢性皮炎散	药物
莫家清宁丸	药物
复方无花果含片	药物
甲基多巴	药物
椎管内神经鞘瘤	疾病
脑脊液天门冬氨酸氨基转移酶	检查科目
蒲地蓝消炎胶囊	药物
莫沙帕明	药物
出生后即有持续青紫	症状
慢性卡他性结膜炎	疾病
楂曲平胃合剂	药物
奥昔非君	药物
花粉过敏性哮喘	疾病
注射用盐酸阿奇霉素	药物
子宫内膜炎	疾病
圆锥角膜	疾病
氧化锌硫软膏	药物
慢性宫颈炎	疾病
进食异常	症状
宫颈炎	疾病
银杏叶软胶囊	药物
舌体肥大	症状
兽医	NoneType
持续性枕后位、枕横位	疾病
心可舒咀嚼片	药物
T8淋巴细胞亚群	检查科目
盐酸托哌酮片	药物
纤维肌痛症	疾病
咽颊部烧伤	症状
雌激素不足	症状
婴儿臀部红	症状
归脾丸(浓缩丸)	药物
松根油吸入剂	药物
胸长神经卡压症	疾病
消洗灵	药物
外用冻干人纤维蛋白粘合剂	药物
震颤	症状
晕车	症状
结核性淋巴结炎	疾病
牛黄蛇胆川贝滴丸	药物
注射用顺铂	药物
平卧呼吸困难	症状
盐酸克林霉素葡萄糖注射液	药物
比拜克胶囊	药物
血塞通滴丸	药物
羚翘解毒丸浓缩丸	药物
继发性化脓性腹膜炎	疾病
腺苷钴胺片	药物
复方消化酶	药物
雷贝拉唑钠	药物
小儿肺动脉高压	疾病
米诺地尔凝胶	药物
鼓胀	疾病
急性肺脓肿	疾病
氟康唑颗粒	药物
硫酸亚铁含片	药物
乳酶生	药物
脾肾双补丸	药物
克拉维酸钾羟氨苄青霉素颗粒剂	药物
海蛇药酒	药物
诊断室中所测血压始终增高	症状
养胃舒胶囊	药物
总三碘甲状腺原氨酸	检查科目
甲型副伤寒菌诊断菌液	药物
青蒿素	药物
曲安奈德	药物
舒筋活络酒	药物
维生素D缺乏病	疾病
窦房结病变	症状
小儿唐氏综合征	疾病
小儿贝诺酯散	药物
小儿毛细支气管炎	疾病
链佐星	药物
会阴部牵引痛	症状
酚咖片	药物
复方乌鸡颗粒	药物
眼内异物	疾病
低血容量性休克	疾病
肛腺分泌减少	症状
枯草芽孢杆菌	药物
慢性头痛	症状
牛奶色或米汤样便	症状
紫菜炒鸡蛋	NoneType
喉头发紧	症状
颌骨错位	症状
耐热力降低	症状
复方天麻蜜环菌片	药物
神经源性膀胱	疾病
复方阿米三嗪片	药物
血肿形成	症状
羌月乳膏	药物
促肾上腺皮质激素	检查科目
细菌性脑膜炎	疾病
扁平骨盆	症状
海昆肾喜胶囊	药物
生殖器疱疹	疾病
金荞麦胶囊	药物
辐射性白内障	疾病
四环素眼膏	药物
尿碘	检查科目
盐酸尼莫司汀	药物
小儿软骨发育不全	疾病
脐带血循环障碍	症状
健血颗粒	药物
拨云退翳丸	药物
青霉胺片	药物
膦甲酸钠葡萄糖注射液	药物
鼻咽清毒剂	药物
左羟丙哌嗪口服溶液	药物
清脑降压片	药物
榄香烯注射液	药物
湿毒疮	疾病
吐泻肚痛散	药物
珍珠灵芝片	药物
肾病综合征	疾病
消结安胶囊	药物
复方电解质眼内冲洗液	药物
流感嗜血杆菌感染	疾病
咳痰合剂	药物
葡钙维B1片	药物
黄精养阴糖浆	药物
红细胞谷胱甘肽合成酶	检查科目
唑尼沙胺	药物
胃区包块	症状
养心宁神丸	药物
虐待	NoneType
消风止痛宁	药物
轻身减肥片	药物
盐酸噻氯匹定胶囊	药物
荨麻疹	疾病
胎儿宫内骨折	症状
尿肾上腺素	检查科目
血清苯丙氨酸	检查科目
妊娠合并尿石症	疾病
驻车丸	药物
碳酸钙D3咀嚼片	药物
盐红菌	细菌
祛痰平喘片	药物
肾盏憩室	疾病
灰泥角化病	疾病
麦迪霉素胶囊	药物
盐酸妥洛特罗片	药物
尿路康颗粒	药物
醋酸环丙孕酮	药物
天花	疾病
归芪养血糖浆	药物
耳溢液	症状
甲状腺激素抵抗综合征	疾病
宫颈前唇水肿	症状
乙型肝炎病毒表面抗原酶联免疫诊断试剂	药物
湿热病	疾病
重组人表皮生长因子衍生物滴眼剂	药物
掌心凹消失或稍隆起	症状
胜红清热胶囊	药物
颈部烧伤	症状
枸橼酸喷托维林片	药物
强力定眩片	药物
自身红细胞过敏性紫癜	疾病
单瘫	症状
铁尘肺	疾病
脑络通胶囊	药物
脚后跟长骨刺	症状
新单亲子女	NoneType
食消饮	药物
短缩舌	症状
右归胶囊	药物
马来酸氯苯那敏控释胶囊	药物
芪天扶正胶囊	药物
局部静脉压痛	症状
眼结膜水肿及角膜溃疡	症状
游走性结节性脂膜炎	疾病
鹿角霜	药物
支气管哮喘	疾病
甲磺酸二氢麦角碱片	药物
辅酶Q10片	药物
双黄连滴眼剂	药物
肝畅胶囊	药物
血小板体积分布宽度	检查科目
缺氧缺血性神经损伤	症状
男性病	疾病
二维钙赖氨酸片	药物
手足发抖	症状
尼美舒利凝胶	药物
溶血过度所致贫血	疾病
气体弥散障碍	症状
阿魏酸钠	药物
肝窦扩张	症状
抗链球菌壁多糖抗体	检查科目
脑缺氧	症状
二十味肉豆蔻丸	药物
小儿锁骨颅骨发育不全综合征	疾病
维替泊芬	药物
职业神经症	症状
颈部呈僵直状	症状
硬柄香菇	NoneType
小儿巨脑畸形综合征	疾病
精子存活率低	症状
腹痛伴便血	症状
葡萄糖酸氯己定软膏	药物
角菜酸酯	药物
结石康胶囊	药物
角化棘皮瘤	疾病
流行性感冒疫苗	药物
痛经口服液	药物
参茸黑锡丸	药物
脑康泰胶囊	药物
诺氟沙星葡萄糖注射液	药物
羊藿益肾酒	药物
外阴瘙痒	疾病
数学	NoneType
惊风丸	药物
马来酸右旋噻吗洛尔滴眼液	药物
老人便秘	症状
赖氨匹林	药物
脾胃舒丸	药物
胆绞痛	症状
冠心七味片	药物
气管闭合性损伤	疾病
多胎妊娠	疾病
妊娠期间小便不通	症状
腰部僵直感	症状
脘痞	症状
小儿胃结块症	疾病
肠易激综合征	疾病
量子力学	NoneType
甲磺酸托烷司琼片	药物
衣原体肺炎	疾病
美扑伪麻口服溶液	药物
脂降宁片	药物
寰椎骨折脱位	疾病
吡咯他尼	药物
小儿胱氨酸病	疾病
颈部淋巴结结核	疾病
速效牛黄丸	药物
尿酸代谢亢进	症状
盐酸索他洛尔注射液	药物
尼氟酸	药物
重庆市高强度聚焦超声肿瘤治疗中心	NoneType
七味诃子散	药物
双丹胶囊	药物
梅毒螺旋体抗体诊断试剂盒(间接酶联免疫法)	药物
甲硝唑阴道凝胶	药物
抗肝细胞膜抗原抗体	检查科目
三氯叔丁醇	药物
输血用1号抗凝液	药物
西吡氯胺含漱液	药物
依米丁	药物
成人型女性乳房肥大症	疾病
猩红热	疾病
N95型口罩	NoneType
金刚乙胺	药物
银红补肾药酒	药物
余甘子喉片	药物
炎症后黑变病	疾病
血浆蛋白检测试剂冻干纤维蛋白(原)降解物(FDP)诊断血球	药物
外伤性胆管损伤	疾病
注射用盐酸哌甲酯	药物
小儿脑膜瘤	疾病
老年人前列腺增生症	疾病
健儿清解液	药物
微小核糖核酸病毒性角膜炎	疾病
晨起肥皮肿	症状
盐酸丙米嗪	药物
虫草被孢菌胶囊	药物
孕妇腿抽筋	症状
汉防己甲素	药物
眼外肌病及弱视	疾病
艾愈胶囊	药物
无水硫酸钠肠溶胶囊	药物
呕血与黑粪	疾病
美羧伪麻颗粒	药物
新生儿化脓性脑膜炎	疾病
补心气口服液	药物
肱二头肌长头腱鞘炎	疾病
兔热病	疾病
五海瘿瘤丸	药物
眩晕宁颗粒	药物
耳廓癣	症状
血清过氧化脂质	检查科目
尿氨基酸氮	检查科目
肋膜腔积水	症状
下腹坠胀	症状
外源性光感性皮炎	疾病
司帕沙星	药物
焦磷酸钙沉积病	疾病
银杏叶提取物滴剂	药物
腰部的不稳交锁现象	症状
慢性创伤性滑囊炎	疾病
风茄平喘膏	药物
小儿右上腹阵发性绞痛	症状
氢溴酸西酞普兰胶囊	药物
弧菌	细菌
小儿药物诱发的溶血性贫血	疾病
酒精性股骨头坏死	疾病
尿道旁腺癌	疾病
痛性阴茎勃起	症状
老年人肾癌	疾病
白线疝	疾病
小儿多源性房性心动过速	疾病
倍他司汀	药物
盐酸吡格列酮	药物
非诺特罗	药物
雪梨膏	药物
盐酸小诺霉素注射液	药物
赛洛唑啉	药物
浓甲硝唑含漱液	药物
复方拳参片	药物
清咽茶	NoneType
蓝苓口服液	药物
小儿共济失调毛细血管扩张综合征	疾病
心气虚	疾病
双肾弥漫性病变	症状
腺病毒性肠炎	疾病
结核灵片	药物
原发免疫性疾病相关的淋巴增殖性疾病	疾病
便隐血胶体金检测试纸	药物
铁棒锤止痛膏	药物
沟裂增宽	症状
盐酸麻黄碱滴鼻剂	药物
橙皮糖浆	药物
四氯化碳中毒	疾病
复方连蒲颗粒	药物
阿魏酸钠葡萄糖注射液	药物
七味通痹口服液	药物
先天性肾上腺皮质增生症	疾病
噻托溴铵	药物
麻疹病毒抗体	检查科目
白血病视网膜病变	疾病
复方甲地孕酮注射液	药物
五仙膏	药物
椎管大小变化	症状
脐膨出	疾病
柴黄片	药物
黄连上清胶囊	药物
枸橼酸喷托维林	药物
乌灵胶囊	药物
格列齐特片	药物
皮肤猪囊尾蚴病	疾病
灯盏花滴丸	药物
广东凉茶	药物
厄多司坦	药物
银杏酮酯分散片	药物
硫康唑	药物
腹膜后感染与脓肿	疾病
新生儿吮乳无力及减少	症状
流泪	症状
中耳炎	疾病
阿司匹林缓释片	药物
板层状鱼鳞病	疾病
复发性多发性软骨炎伴发的葡萄膜炎	疾病
咽喉及口内刺痒	症状
尿液混浊	症状
阿托伐醌	药物
盐酸多西环素片	药物
肾萎缩	疾病
注射用重组人白细胞介素11	药物
稻农皮炎	疾病
甲状旁腺激素	检查科目
睾丸胀痛	症状
癌性疼痛	疾病
清眩片	药物
复方甲亢膏	药物
甲状腺素放免药盒	药物
移行脊椎	疾病
颈肋畸形	疾病
小儿肾结核	疾病
肱骨内上髁炎	疾病
启脾口服液	药物
灭菌注射用水	药物
糖尿病性胃轻瘫	疾病
复方枇杷糖浆	药物
先天性食管憩室	疾病
老年性紫癜	疾病
小儿α1-抗胰蛋白酶缺乏症	疾病
厥脱	疾病
阴茎疼痛	症状
下部附加前根脊髓动脉缺血症候群	疾病
肘外翻畸形	疾病
腰椎间盘突出症	疾病
醋酸曲安奈德	药物
梁财信跌打丸	药物
奥沙普秦分散片	药物
气管食管瘘	疾病
盐酸多柔比星注射液	药物
丙卡巴肼	药物
视物变小	症状
肺组织细胞增生症	疾病
醋酸可的松眼液	药物
远志流浸膏	药物
心脏黏液瘤	疾病
三峰热型	症状
氨酚巴妥片	药物
萘丁美酮片	药物
自身免疫性胰腺炎	疾病
飞扬肠胃炎片	药物
视网膜后膜	疾病
颈静脉怒张	症状
复方鳖甲软肝片	药物
武汉	NoneType
太和妙灵丸	药物
健胃宽胸丸	药物
食管左壁形成压足跡	症状
迷路炎	疾病
血吸虫虫卵抗体诊断试剂盒(酶联免疫法)	药物
应激功能减退	症状
指甲类似云母	症状
脑脊液P物质	检查科目
偏头痛	疾病
乳腺隐痛	症状
睡眠-觉醒时间程序的障碍	症状
唇风	疾病
十二指肠壅积症	疾病
小儿眼-脑-肾综合征	疾病
戊四硝酯粉	药物
合成树脂皮炎	疾病
烦渴多饮	症状
益精口服液	药物
沙苑子颗粒	药物
慢性劳损性颈背部筋膜纤维织炎	疾病
松果体瘤	疾病
急性盆腔炎	疾病
卵巢性不孕	疾病
创伤性骨髓炎	疾病
灵芝浸膏片	药物
蹲下起来后眼前发黑	症状
菊蓝抗流感片	药物
通宣理肺冲剂	药物
阿莫西林氟氯西林	药物
小儿黄水疮	疾病
后葡萄膜炎	疾病
葡萄球菌性烫伤样皮肤综合征	疾病
苯唑西林钠胶囊	药物
新霉素	药物
二巯丙磺钠注射液	药物
三孢布拉霉	细菌
高血脂性血管损害	症状
头孢特仑	药物
噤口痢	疾病
胸壁静脉炎	疾病
增殖腺肥大	症状
牛黄抱龙片	药物
小儿弓形腿综合征	疾病
羟丁酸钠	药物
立氏立克次体斑疹热	疾病
张文宏	NoneType
复方乌鸡胶囊	药物
蝶骨嵴脑膜瘤眼部病变	疾病
儿童遗尿症	疾病
贝敏伪麻片	药物
止嗽袋泡茶	药物
缬沙坦	药物
硫酸钡混悬液	药物
麝香拔湿膏	药物
各类贫血伴发的精神障碍	疾病
疼痛性股白肿	症状
盐酸克林霉素棕榈酸酯颗粒	药物
移行病变	症状
铍及其化合物引起的皮肤病	疾病
泻停封胶囊	药物
阿昔洛韦眼膏	药物
着色芽生菌病和暗色丝孢霉病	疾病
吡嗪酰胺胶囊	药物
黄柏八味散	药物
硫酸链霉素片	药物
利凡斯的明	药物
气急	症状
注射用盐酸大观霉素	药物
蛇胆陈皮液	药物
心脏内粘液瘤	疾病
甲硫酸新斯的明注射液	药物
前列舒丸	药物
眼前冒紫烟	症状
精神依赖性	症状
胼胝体进行性变性	疾病
当归寄生注射液	药物
拨云复光散	药物
抗登革病毒IgG抗体	检查科目
克林霉素磷酸酯葡萄糖注射液	药物
三维亚铁咀嚼片	药物
盐酸曲马多葡萄糖注射液	药物
蛋白质-能量营养不良	疾病
溶血尿毒综合征	疾病
老年人高血压	疾病
虹膜根部离断	症状
五味健脑口服液	药物
先天性直肠肛门畸形	疾病
小儿苯丙酮尿症	疾病
解毒通淋丸	药物
马来酸左旋氨氯地平	药物
蠕虫病毒Win32.Kebede.I	NoneType
妇炎平泡腾片	药物
芙蓉抗流感片	药物
急性坏死出血性脑脊髓炎	疾病
银翘解毒软胶囊	药物
脑心安胶囊	药物
祛风除湿药酒	药物
血浆蛋白检测试剂白蛋白(Alb)抗血清	药物
TORCH检查	检查科目
盐酸普鲁卡因胺	药物
失读	症状
炎热清胶囊	药物
颚口线虫病	疾病
呋噻米片	药物
米托蒽醌	药物
克拉伯病	疾病
克林霉素磷酸酯栓	药物
日舒安湿巾	药物
云南蛇药	药物
红细胞乳酸脱氢酶	检查科目
磷酸苯丙哌林分散片	药物
小儿化食丸	药物
氢溴酸樟柳碱片	药物
氯噻平	药物
活胃散	药物
镰刀菌病	疾病
支气管病	疾病
复方桔梗远志麻黄碱片I	药物
聚维酮碘药膜	药物
酮洛芬肠溶胶囊	药物
容易激动	症状
病毒性肠炎	疾病
虎潜丸	药物
新生儿低体温	疾病
复方双花片	药物
氢溴酸右美沙芬口服液	药物
传染性软疣	疾病
甲巯咪唑片	药物
老年性舞蹈病	疾病
鼻血止颗粒	药物
组胺	药物
唇干裂	症状
巴柳氮二钠	药物
粪便嵌塞	症状
红细胞变形性	检查科目
双黄连粉针剂	药物
正骨膏	药物
复方甘露醇注射液	药物
复方氨酚烷胺颗粒	药物
黄连上清颗粒	药物
秋水仙碱	药物
消朦胶囊	药物
磷霉素钙颗粒	药物
复方盐酸麻黄碱软膏	药物
早泄	疾病
磷霉素	药物
皮肤转移	症状
子宫下垂	症状
小儿特发性血小板减少性紫癜	疾病
体位性震颤	症状
珍珠丘疹	疾病
肝炎	疾病
泊洛沙姆	药物
精神心理科	医学专科
表皮发生钙化	症状
纵隔气肿	疾病
胃脘饱胀	症状
疖与疖病	疾病
软化斑	疾病
心率过缓	症状
陈香露白露胶囊	药物
抗炎退热片	药物
银翘散	药物
柴银口服液	药物
开胸顺气丸	药物
肥胖型人格	NoneType
麻黄碱	药物
关节囊损伤	症状
牛黄解毒片	药物
氟胞嘧啶注射液	药物
孕妇肚子痒	症状
哌硝噻唑	药物
多克隆型冷球蛋白血症	症状
利咽解毒颗粒	药物
小儿双唇综合征	疾病
八珍补汁	药物
双氯芬酸钠滴眼液	药物
宁心安神颗粒	药物
风寒咳嗽冲剂	药物
百日咳片	药物
肺火	症状
老年人胃食管反流病	疾病
卡芦莫南	药物
浅表淋巴结进行性肿大	症状
淋球菌性腹膜炎	疾病
下半身消瘦型	症状
红细胞计数	检查科目
疣状癌	疾病
胸壁血管充盈	症状
血清铯	检查科目
畸形性吞咽困难	疾病
人参灵芝胶囊	药物
血清甲状腺素	检查科目
围绝经期综合征	疾病
肾康注射液	药物
产后无乳汁分泌	症状
脑脊液脑膜炎球菌抗原	检查科目
逐瘀消肿膏	药物
炔雌醇片	药物
奥美拉唑胶囊	药物
婴儿睡觉出汗	症状
止血散	药物
叹气后舒服	症状
小儿一氧化碳中毒	疾病
阴道腺病	疾病
平喘抗炎胶囊	药物
阿胶口服液	药物
戊型肝炎病毒抗体诊断试剂	药物
小儿戈谢病	疾病
祛风止痛胶囊	药物
冻干多价气性坏疽抗毒素	药物
芬太尼	药物
四环素胶囊	药物
脉络膜骨瘤	疾病
尿隐血	症状
葡萄座腔菌	细菌
后发性遗忘	症状
腕关节扭挫伤	症状
蚂蚁双参通痹丸	药物
伯克氏菌属	细菌
当归南枣片	药物
盐酸氨溴索胶囊	药物
冻干精制人白细胞干扰素	药物
丝裂霉素	药物
一过性红斑狼疮样	症状
神经节苷酯	药物
复方五味子片	药物
输卵管妊娠流产	疾病
少腹逐瘀胶囊	药物
膀胱咳	疾病
盐酸阿夫唑嗪片	药物
愈肝龙颗粒	药物
复方三维亚油酸胶丸	药物
习惯性流产	疾病
安宫牛黄丸	药物
小儿转移性骨肿瘤	疾病
抗甲状腺过氧化物酶自身抗体	检查科目
清热祛湿颗粒	药物
西瓜	NoneType
止咳枇杷冲剂	药物
老年挛缩	疾病
芪蛭降糖片	药物
髌前空虚感	症状
硫酸巴龙霉素片	药物
布氏菌肺炎	疾病
二尖瓣和主动脉瓣的疾患	疾病
复方蛋氨酸胆碱片	药物
八宝拨云散	药物
脑血康口服液	药物
山蜡梅叶片	药物
口腔科	医学专科
芎菊上清片	药物
葶贝胶囊	药物
十一味金色丸	药物
阿魏酸哌嗪片	药物
阿米巴原虫抗原和抗体	检查科目
阿司匹林散	药物
大颗粒淋巴细胞白血病	疾病
锑中毒	疾病
胁部肿胀	症状
森林脑炎	疾病
香砂平胃颗粒	药物
颅底畸形	症状
黑痣	症状
巨脑回畸形	疾病
抗着丝点抗体单胺氧化酶	检查科目
胸骨后烧灼样痛	症状
颈肋综合征	疾病
小儿原发性纤毛运动障碍	疾病
强迫行为	症状
炭疽芽孢杆菌	细菌
方肩畸形	症状
盐酸仑氨西林片	药物
烟酸注射液	药物
盐酸洛美沙星片	药物
脊髓前中央动脉缺血症候群	疾病
小儿氨酚那敏颗粒	药物
诺氟沙星药膜	药物
风寒感冒冲剂	药物
万金香气雾剂	药物
血液	药物
牙的咀嚼磨损	症状
盐酸赛洛唑啉滴鼻液	药物
薄荷茴桉苯甲酸钠含片	药物
东方胃药胶囊	药物
血脂灵胶囊	药物
拒食	症状
贝美格注射液	药物
遗传性凝血因子ⅩⅢ缺乏	疾病
髓性纤维化	症状
胫骨粗隆肿胀	症状
视神经疾病	疾病
果糖	药物
Pancoast综合征	疾病
银杏叶滴剂	药物
复方苯甲酸酊	药物
中暑衰竭	疾病
偏侧不注意	症状
更年安片	药物
胞痹	疾病
驱风药酒	药物
复方维A酸凝胶	药物
蟹黄肤宁软膏	药物
雌二醇	药物
气滞血瘀	症状
双掌猿线出现率增加和atd角增大	症状
复方硫酸氢黄连素软膏	药物
盐酸阿比朵尔胶囊	药物
乳酸钠林格	药物
异福胶囊	药物
铝镁混悬液	药物
猝倒	症状
遗传性乳光牙	疾病
遗传性感觉神经病	疾病
竭红跌打酊	药物
腹部“柔韧感”体征	症状
加速性室性自主心律	疾病
小儿汞中毒	疾病
秋水仙胺	药物
点状痤疮	症状
口唇发黄	症状
复方气管炎片	药物
宫颈腺癌	疾病
骨结核	疾病
急性间歇性卟啉病	疾病
性交困难	症状
双氢睾酮	检查科目
面红和面红恐惧症	疾病
罗布麻叶胶囊	药物
大三阳	症状
糖类皮质激素分泌过少	症状
多房棘球蚴病	疾病
白酱感冒颗粒	药物
虎梅含片	药物
放射性周围神经病	疾病
钒及其化合物引起的皮肤病	疾病
狼疮细胞试验	检查科目
氨甲苯酸葡萄糖注射液	药物
蛇胆川贝软胶囊	药物
外阴天疱疮	疾病
头风病	疾病
肝功检查胆红素及转氨酶常增高	症状
暑湿感冒颗粒	药物
小肠腺癌	疾病
甘磷酰芥片	药物
皮肤淋巴细胞浸润症	疾病
小儿血管免疫母细胞淋巴结病	疾病
听力障碍	疾病
直肠息肉	疾病
液状石蜡	药物
胸椎椎管狭窄症	疾病
痉笑面容	症状
咽部和喉部危象	症状
乳癖清胶囊	药物
突发的右侧心衰	症状
咳停片	药物
梅尼埃病	疾病
利巴韦林葡萄糖注射液	药物
聚磺苯乙烯钠散	药物
南京医科大学	NoneType
老蔻丸	药物
红粉	药物
血清碱性磷酸酶	检查科目
安康心宝丸	药物
恶性萎缩性丘疹病	疾病
心房扑动	疾病
小檗碱甲氧苄啶片	药物
儿科七厘散	药物
芪棱片	药物
阿德福韦酯	药物
盐酸托烷司琼氯化钠注射液	药物
颈舒颗粒	药物
养心定悸口服液	药物
感染诱发昏迷	症状
左金胶囊	药物
宜肝乐颗粒	药物
蒿蓝感冒颗粒	药物
人乳头瘤病毒感染	疾病
骨碱性磷酸酶试剂盒	药物
老年人小腿浮肿	症状
八珍袋泡茶	药物
链核盘菌	细菌
结肠黑变	症状
维生素B12吸收不良	症状
复方祖司麻止痛膏	药物
眼前异常闪光，增加的黑点	症状
脉管复康片	药物
青枝骨折	症状
鼻窦压痛	症状
感冒药片	药物
眼球压痛	症状
面部皮肤有结节状增生	症状
硫酸双肼屈嗪	药物
双耳廓发育不全	症状
皮肤钙化	症状
尿道局部肿胀	症状
遇冷后排汗增多	症状
复方枇杷止咳冲剂	药物
斑蝥素乳膏	药物
盐酸三氟拉嗪片	药物
小儿急性胃炎	疾病
盐酸阿夫唑嗪缓释片	药物
氨咖敏片	药物
益肺健脾颗粒	药物
棕榈氯霉素(B型)颗粒	药物
脂溢性角化病	疾病
膈先天性缺损	疾病
薄芝糖肽	药物
脑脊液游离型髓鞘碱性蛋白	检查科目
小儿脓窠疮	疾病
主动脉瓣膜部狭窄	疾病
祛伤消肿酊	药物
复方氯乙烷气雾剂	药物
三七丹参颗粒	药物
合成天麻素	药物
心血虚	疾病
依诺沙星	药物
护肝颗粒	药物
阿昔洛韦胶囊	药物
止咳定喘丸	药物
孕康口服液	药物
工业毒物中毒性周围神经病	疾病
骨裂	疾病
二十一味寒水石散	药物
血塞通软胶囊	药物
月芝软胶囊	药物
脑挫裂伤	疾病
筋痛消酊	药物
口服四维葡萄糖	药物
胆汁返流	症状
抗免疫球蛋白G血清羊抗鼠(BALB/c)IgG血清	药物
牙周袋形成	症状
复方土槿皮酊	药物
异福酰胺胶囊	药物
十二指肠憩室梗阻性黄疸综合征	疾病
妊娠斑	症状
次甲氯地孕酮	药物
小儿变形性肌张力障碍	疾病
大隐静脉曲张	疾病
土霉素碱	药物
普通变形杆菌	细菌
婴儿脊柱侧凸	症状
眼球不同轴	症状
尼美舒利干混悬剂	药物
男春宝胶囊	药物
小儿淋巴样息肉	疾病
口腔溃疡散	药物
息积	疾病
小儿亚硝酸盐中毒	疾病
三十一味松石丸	药物
失眠抑郁	疾病
克洛曲片	药物
归芍地黄丸	药物
中性粒细胞增高	症状
脑瘤	疾病
肥大结节纤维组织增生	症状
红细胞葡萄糖磷酸异构酶	检查科目
髓样癌变	症状
富马酸酮替芬滴鼻液	药物
硝酸银软膏	药物
注射用复方甘草酸单铵S	药物
复方大青叶合剂	药物
噎痛感	症状
加利福尼亚脑炎	疾病
肝气郁节	症状
磷苯妥英	药物
乙型脑炎纯化疫苗	药物
舒泌通胶囊	药物
膀胱湿热	疾病
肺源性心脏衰竭	症状
追风丸	药物
孕妇全身性水肿	症状
平消胶囊	药物
牙齿松动和脱落	症状
百会穴	NoneType
骨友灵贴膏	药物
局方至宝散	药物
科长	NoneType
肾盂肾炎	疾病
参附脱毒胶囊	药物
烫伤	疾病
速效救心丸	药物
中毒严重	症状
口鼻生疮	症状
补骨脂注射液	药物
小儿先天性肌强直综合征	疾病
外用盐酸氨酮戊酸散	药物
红细胞环状体	检查科目
郁证	疾病
组织细胞纤维瘤	疾病
消化道内毛石或毛粪石形成	症状
围绝经期前后的外阴白色病变	疾病
二氯醋酸二异丙胺	药物
消瘰夏枯草膏	药物
诺氟沙星注射液	药物
小儿脉络丛乳头状瘤	疾病
产褥期恶露	症状
磷酸组胺注射液	药物
限制型心肌病	疾病
食管管型	疾病
封髓丸	药物
冻干人凝血因子VIII	药物
消化内科	医学专科
乙酰麦迪霉素	药物
小儿无甲状腺性克汀病	疾病
涎瘘	疾病
赛霉安乳膏	药物
心脏肥大	症状
喉痛灵冲剂	药物
苹果酸氯波比利	药物
胸腺肽肠溶片	药物
晕可平颗粒	药物
绿菇	NoneType
麻醉乙醚	药物
系统性红斑狼疮伴发的精神障碍	疾病
乳腺结核	疾病
多发性神经炎	疾病
咬痛	症状
止咳平喘膏	药物
生孢梭菌	细菌
类丹毒	疾病
小袋纤毛虫病	疾病
脑心舒	药物
单次发作抑郁症	疾病
盐酸特拉唑嗪	药物
礞石滚痰丸	药物
香药胃安胶囊	药物
熊胆舒肝利胆胶囊	药物
干酪性鼻炎	疾病
脑脊液鼻漏	疾病
咽部创伤	疾病
氢化可地松注射液	药物
细菌协同性坏疽	疾病
虚脉	症状
新生儿出血症	疾病
复方磺胺脒片	药物
如意定喘片	药物
抗人免疫球蛋白轻链k/型诊断血清	药物
复方吡拉西坦脑蛋白水解物片	药物
复方地西泮片	药物
酚麻美敏口服溶液	药物
骶髂部剧烈疼痛	症状
皮肤硬化	症状
先天性性联无γ-球蛋白血症	疾病
乳酸亚铁	药物
上肢突然出现肿胀酸痛	症状
脊柱裂	疾病
葡萄糖酸镁	药物
疱疹性角膜炎	疾病
醋酸可的松眼膏	药物
肠道沙门氏菌	细菌
双氯酚酸钠栓	药物
椒疮	疾病
牡荆油丸	药物
糜蛋白酶	药物
曲安缩松尿素乳膏	药物
夜宁颗粒	药物
参鹿扶正合剂	药物
胫腓骨骨干骨折	疾病
卡波西水痘样疹	疾病
茴三硫	药物
盐酸左旋咪唑搽剂	药物
癫痫	疾病
无名指半月甲呈粉红色	症状
特洛伊病毒Win32.Cutwail.GG	NoneType
眼酸碱化学伤	疾病
拇食指捏物功能障碍	症状
颈椎间盘突出	症状
胺安颗粒	药物
苦甘冲剂	药物
晕针	症状
氟曲马唑	药物
山楂精降脂滴丸	药物
脑脊液铜	检查科目
脏腑功能失调	症状
强碱类中毒	疾病
酒红链霉菌	细菌
坤月安颗粒	药物
冷抗体型自身免疫性溶血性贫血	疾病
加贝酯	药物
血清C1q	检查科目
匹多莫德	药物
沙芬伪麻咀嚼片	药物
肠梨形鞭毛虫病	疾病
龟芪参口服液	药物
维生素AD胶丸	药物
胃空肠输入袢综合征	疾病
持续性疼痛	症状
祖卡木胶囊	药物
磺胺醋酰钠滴眼液	药物
心房颤动	疾病
冬眠瘤	疾病
肘关节强直与纤维性僵硬	疾病
获得性肥胖	症状
福辛普利钠	药物
维生素E粉	药物
失用步态	症状
复方锁阳口服液	药物
乳房神经纤维瘤	疾病
结节病性心肌病	疾病
双肺的吸气爆裂音	症状
麻芩止咳糖浆	药物
牛黄消炎灵胶囊	药物
盐酸川芎嗪	药物
浅眠	症状
水痛症	疾病
镇心痛颗粒	药物
注射用天麻素	药物
铁利用性贫血	疾病
依曲替酯	药物
正胃片	药物
骶骨骨折	疾病
医痫丸	药物
尿钠排出量极低	症状
法医昆虫学	NoneType
交肠	疾病
强制性哭笑	症状
肘管综合征	疾病
正柴胡饮冲剂	药物
小儿迁延与慢性腹泻	疾病
硒及其化合物引起的皮肤病	疾病
玉泉胶囊	药物
小儿后尿道瓣膜	疾病
小儿周期性低血钾性麻痹	疾病
阿立哌唑片	药物
白痧散	药物
视交叉病变	疾病
不能向尺侧屈腕及屈环小指远侧指关节	症状
独角膏	药物
培维索孟	药物
补肾益寿片	药物
鼻甲肿胀	症状
贝母枇杷糖浆	药物
枕横位入盆	症状
蝰蛇毒磷脂凝固时间	检查科目
盐酸普鲁卡因胺片	药物
小儿止咳糖浆	药物
不自主运动	症状
星形病毒胃肠炎	疾病
哈西奈德	药物
虹膜炎	疾病
局方至宝丸	药物
复方柳菊颗粒	药物
结直肠癌	疾病
指甲-髌骨综合征	疾病
合成鱼腥草素片	药物
脑脊液肌酸激酶	检查科目
羟乙基淀粉20氯化钠注射液	药物
拇指三节	症状
小活络丹	药物
槟榔四消片	药物
麝珠明目滴眼液	药物
阴茎痰核	疾病
黄体囊肿	疾病
虎地胶囊	药物
叶绿素铜钠	药物
煤焦油	药物
脑癌	疾病
腹壁不自主轴动	症状
参梅养胃冲剂	药物
泄殖腔外翻	疾病
吸附百日咳白喉破伤风乙型肝炎联合疫苗	药物
公共卫生事件	NoneType
丹郁骨康丸	药物
米氮平片	药物
婴儿含吮时乳头刀割样疼痛并渗血	症状
一捻金胶囊	药物
葡萄糖酸亚铁胶囊	药物
甲氨蝶呤相关的淋巴增殖性疾病	疾病
调经止痛胶囊	药物
淋巴液流出	症状
猩红热样红斑	疾病
龙凤宝胶囊	药物
春季卡他性结膜炎	疾病
小阴唇及前庭也有散在的白色圆形及环形丘疹	症状
复方益母颗粒	药物
鼻瓣区狭窄	疾病
杜仲补腰合剂	药物
妊娠高血压综合征眼底病变	疾病
保妇康泡沫剂	药物
大阴唇或肛门大小不等、质软无压痛包块	症状
小儿硬脑膜外脓肿	疾病
碘海醇注射液	药物
麻疹样红斑型药疹	疾病
小儿复方麝香草酚撒粉	药物
原发性开角型青光眼	疾病
婴儿湿疹	疾病
连翘败毒膏	药物
肠毒性大肠埃希杆菌感染	疾病
饮酒性面红	症状
偏侧空间忽略症	症状
跌打丸	药物
五子降脂胶囊	药物
鱼石脂颠茄软膏	药物
红香止痛酊	药物
夏天无注射液	药物
金硫葡糖	药物
伤寒菌H诊断菌液	药物
眼裂歪斜	症状
硫柳汞钠	药物
小肠结肠炎耶尔森菌肺炎	疾病
丹参合剂	药物
霍奇金淋巴瘤	疾病
乌鸡丸	药物
盐酸左氧氟沙星葡萄糖注射液	药物
咯多量血性泡沫痰	症状
盐酸氟桂利嗪片	药物
口腔黏膜下纤维化	疾病
妊娠中毒	症状
过敏性结肠炎	疾病
环磷酰胺片	药物
咬合关系错乱	症状
后牙反	疾病
头孢氨苄片	药物
肾舒冲剂	药物
牛黄痔清栓	药物
恶性脑膜瘤	疾病
蝙蝠	NoneType
甜梦口服液	药物
着色杆菌病	疾病
黏脂贮积症Ⅲ型	疾病
先天性缺额牙	疾病
复方甲亢宁片	药物
精神过敏	症状
多毛症	疾病
注射用水溶性维生素	药物
小儿维生素B6缺乏病	疾病
流行性乙型脑炎病毒诊断血清	药物
阿巴卡韦	药物
盐酸利多卡因胶浆	药物
胃炎宁颗粒	药物
金衣至宝锭	药物
危害因素	NoneType
复方炔诺酮片	药物
科干综合征	疾病
沈阳红药胶囊	药物
注射用氧氟沙星	药物
嗜睡	症状
茸血补脑液	药物
木僵	症状
稀便	症状
视野缩小	症状
奎尼丁	药物
外展型骨折	症状
叶间裂移位	症状
成人类风湿性关节炎性巩膜炎	疾病
元神安颗粒	药物
注射用呋脲苄西林钠	药物
胃福颗粒	药物
雄激素过少	症状
淋巴炎	疾病
先天性囊状腺样畸形	疾病
调经化瘀丸	药物
寒喘祖帕颗粒	药物
新福菌素注射液	药物
罗黄降压片	药物
穿龙骨刺片	药物
胃康宁片	药物
度米芬喉片	药物
小儿侏儒-视网膜萎缩-耳聋综合征	疾病
军团菌肺炎	疾病
氨苄青霉素钠栓	药物
注射用骨肽	药物
非诺洛芬钙	药物
盐酸尼卡地平注射液	药物
苄噻嗪	药物
卵巢性闭经	症状
大败毒胶囊	药物
复聪现象	症状
经期肿胀	症状
银菊清解片	药物
桉氨溶液	药物
橙皮酊	药物
硫酸阿托品注射液	药物
龟头炎	疾病
潜在中毒	症状
手烧伤	疾病
肝部疼痛	症状
疤痕	疾病
鼻唇沟发红皲裂	症状
茜草双酯片	药物
侵蚀性水疱	症状
硫酸锌片	药物
异常血红蛋白病	疾病
脑动脉盗血综合征	疾病
庆大霉素硝酸铋胶囊	药物
别嘌醇缓释胶囊	药物
腹泻为水样带黏液恶臭无脓血	症状
安神糖浆	药物
复方肾炎片	药物
鸢都寒痹液	药物
乌司他丁注射液	药物
传染性湿疹样皮炎	疾病
法医病理学	NoneType
盐酸克林霉素胶囊	药物
复方右旋糖酐70滴眼液	药物
血中钙离子过高	症状
聚乙二醇	药物
cmd.exe病毒	NoneType
水飞蓟宾葡甲胺	药物
急性淋巴管炎	疾病
注射用硫酸软骨素	药物
阴蒂肥大	症状
沙眼	疾病
癌胚抗原(CEA)定量测定试剂盒(酶联免疫法)	药物
口干舌燥	症状
复方活脑舒胶囊	药物
阿莫西林克拉维酸钾干混悬剂	药物
腓总神经卡压症	疾病
气管、支气管狭窄	疾病
核心抗体（抗HBc）阳性	症状
急性多发性龈脓肿	疾病
小儿食物变态反应	疾病
青蒿鳖甲片	药物
硝酸甘油氯化钠注射液	药物
慢性结肠炎	疾病
皱缩红细胞	检查科目
温和气单胞菌	细菌
金荞麦片	药物
礞石滚痰片	药物
肾下垂	疾病
穿心莲内酯片	药物
白益镇惊丸	药物
己酸羟孕酮	药物
甲羟孕酮	药物
盐酸司来吉兰	药物
黄芪精	药物
补肾防喘片	药物
罗浮山百草油	药物
妇科调经片	药物
金红颗粒	药物
荆菊感冒片	药物
利奈唑胺	药物
窦性期前收缩	疾病
氨力农注射液	药物
角膜知觉减少	症状
口服蜡样芽孢杆菌活菌片	药物
增效牛黄喉症胶囊	药物
头孢泊肟酯干混悬剂	药物
感觉性共济失调步态	症状
菊蓝抗流感胶囊	药物
钙化性牙源性囊肿	疾病
脑脊液内皮素	检查科目
乙酰唑胺	药物
注射用盐酸瑞芬太尼	药物
痛经宁糖浆	药物
龟分枝杆菌感染	疾病
异维A酸软胶囊	药物
抗感泡腾片	药物
无欲-运动不能-意志缺乏综合征	症状
小儿紫草丸	药物
复方炔诺孕酮滴丸	药物
过敏性血管炎	疾病
药物中毒性周围神经病	疾病
会阴部烧伤	疾病
食瘕	疾病
人性的弱点	NoneType
非那吡啶	药物
情感性心境障碍	疾病
左心室恶性施万瘤	疾病
强迫性人格	症状
米那普仑	药物
颅狭症	疾病
阿片中毒	疾病
蓝芷安脑胶囊	药物
露阴癖	疾病
子宫腺肌病	疾病
系统性红斑狼疮所致脊髓病	疾病
枸橼酸锌	药物
股前外侧麻木、蚁行感	症状
复方甘草片	药物
溶血性乙型脑炎补体结合试验	检查科目
复方百部止咳冲剂	药物
天凤胃痛散	药物
山梨醇	药物
阵挛-强直型	症状
阿奇霉素糖浆	药物
丙谷胺	药物
止喘灵口服液	药物
叶酸注射液	药物
复方五指柑片	药物
血浆蛋白检测试剂补体成份C5抗血清	药物
乳腺癌肉瘤	疾病
骶管囊肿	疾病
益肾壮阳膏	药物
芩连片	药物
秘治胶囊	药物
阳痿	疾病
颈椎过伸性损伤	疾病
阿维A酯	药物
链球菌性咽炎	疾病
八珍益母胶囊	药物
羊角拗苷	药物
蚁参蠲痹胶囊	药物
副球孢子菌病	疾病
外加剂	NoneType
会阴部撕裂感	症状
雷诺病	疾病
更年安胶囊	药物
蜈蚣蜇伤	疾病
摩擦黑变病	疾病
屈光参差性弱视	症状
安康颗粒	药物
云南白药痔疮膏	药物
乳糜泻	疾病
白花蛇膏	药物
肠狭窄	症状
角膜上点状暗灰色混浊	症状
深侧鼻塞	症状
儿童股骨头坏死	疾病
乙肝表面抗原（HBsAg）阳性	症状
参芪蛤蚧补浆	药物
烧伤肤康液	药物
始基子宫	症状
萘哌地尔胶囊	药物
婴儿腹部远心性脂肪营养不良	疾病
胃轻瘫综合征	疾病
活动后气促	症状
阑尾寄生虫病	疾病
雷诺嗪	药物
躁狂与昏睡交替	症状
白带异常	疾病
颐和春胶囊	药物
软腭运动不对称	症状
注射用盐酸雷尼替丁	药物
化瘀祛斑胶囊	药物
舒胆通	药物
诉讼狂	症状
宫糜膏	药物
酚红排泄试验	检查科目
去甲万古霉素	药物
继发性高血压	疾病
利巴韦林注射液	药物
复方甲硝唑阴道栓	药物
酒胀	疾病
小儿生理性贫血	症状
诺瓦克病毒性胃肠炎	疾病
松花散	药物
正柴胡饮颗粒	药物
先天性视网膜劈裂	疾病
宫炎平胶囊	药物
小儿新变异型克罗伊茨费尔特-雅各布病	疾病
小儿咳嗽宁糖浆	药物
额叶癫痫的前额极区发作	症状
藿香万应散	药物
PUVA雀斑样痣	疾病
反复抽搐	症状
外耳道外生骨疣	疾病
益心舒颗粒	药物
婴儿闷热综合症	疾病
复方双花糖浆	药物
甲磺酸双氢麦角碱片	药物
肌肉挫伤	症状
青叶胆提取物	药物
黑色素斑-胃肠多发性息肉综合征	疾病
一氧化碳中毒	疾病
恐风	症状
氯美扎酮片	药物
果糖二磷酸钠	药物
女性体毛多	症状
羊水中有胎粪	症状
粟丘疹	疾病
益肝乐冲剂	药物
心痛康胶囊	药物
胰腺内钙化	症状
重组改构人肿瘤坏死因子	药物
表皮囊肿	疾病
突眼症	症状
深痱	症状
肾复康片	药物
阴茎纤维性海绵体炎	疾病
梅毒螺旋体抗体胶体金诊断试剂	药物
盐酸普鲁卡因胶囊	药物
长春西汀片	药物
骨不连	疾病
香附丸	药物
克霉唑软膏	药物
小儿亚急性骨髓炎	疾病
木香理气丸	药物
盐酸恩丹西酮注射液	药物
宾斯旺格病	疾病
原发性皮肤滤泡中心细胞性淋巴瘤	疾病
盐酸洛美沙星氯化钠注射液	药物
人参首乌精	药物
十二味翼首散	药物
除湿白带丸	药物
壮腰健肾片	药物
乙肝解毒丸	药物
组织液渗出	症状
阴道持续流血不停	症状
辛伐他汀胶囊	药物
喉结核	疾病
小儿先天性巨结肠	疾病
胸口闪电疼痛	症状
皮肤变薄、发亮	症状
考登病中的多发性毛鞘瘤	疾病
小儿莫拉雷脑膜炎	疾病
三七活血丸	药物
罗库溴铵	药物
济众酊	药物
选择性IgA缺乏症	疾病
右旋布洛芬片	药物
肛管直肠周围脓肿	疾病
都梁滴丸	药物
牙根纵裂	疾病
参茸丸	药物
风湿液	药物
维血康颗粒	药物
粪形状和硬度	检查科目
血清胆固醇	检查科目
腐生葡萄球菌	细菌
老年人脑心综合征	疾病
小脑失调症	症状
协日嘎四味汤胶囊	药物
敌鼠中毒	疾病
克利贝特	药物
胆汁淤积性黄疸	疾病
黄芩	药物
杏香兔耳风胶囊	药物
小儿消食开胃颗粒	药物
羚贝止咳糖浆	药物
小儿胃宝片	药物
碘苯酯	药物
热溶血试验	检查科目
氯胍	药物
附红细胞体病	疾病
脚外侧疼	症状
炔诺孕酮炔雌醚	药物
葶苈降血脂颗粒	药物
金果饮咽喉片	药物
利福平滴眼液	药物
急性横贯性脊髓炎	疾病
四香祛湿丸	药物
十七味寒水石丸	药物
呼吸性碱中毒	疾病
皮肤轻度糜烂	症状
炎症性肠道疾病及其伴发的葡萄膜炎	疾病
脑萎缩	疾病
复方磷酸可待因口服溶液	药物
去氨加压素	药物
宫炎康胶囊	药物
病毒性肺炎	疾病
竹沥颗粒	药物
卵巢肿瘤	疾病
输尿管瓣膜	疾病
伊班膦酸钠	药物
原发性阴道恶性淋巴瘤	疾病
小腿瘙痒干燥	症状
皮下脂肪肉芽肿	疾病
多索茶碱葡萄糖注射液	药物
四味通络胶囊	药物
当归丸	药物
刺五加脑灵液	药物
丙酸氯倍他索乳膏	药物
毛圆线虫病	疾病
利鲁唑胶囊	药物
癃闭舒胶囊	药物
氯乙烷	药物
酮替芬	药物
回肠重复畸形	症状
秋水仙碱片	药物
包茎	疾病
注射用盐酸雷莫司琼	药物
甘露聚糖肽口服液	药物
贾氏疗法	NoneType
扭转动作	症状
念珠菌病	疾病
尺神经损伤	疾病
跌打风湿酒	药物
小儿麻甘冲剂	药物
莪术油注射液	药物
他莫昔芬	药物
小儿血小板无力症	疾病
双橘颗粒	药物
癌肿性关节炎	疾病
富马酸异丙吡仑片	药物
右泛醇	药物
胆影葡胺	药物
电击样剧痛	症状
磺胺嘧啶眼膏	药物
肝脏外伤	疾病
糖尿病坏疽	疾病
急性乳突炎	疾病
小儿喘息样支气管炎	疾病
小肠损伤	疾病
遗传性良性上皮内角化不良	疾病
胃安宁片	药物
酚妥拉明	药物
木糖醇注射液	药物
虚寒泄泻	疾病
额部肿块	症状
盐酸卡替洛尔滴眼液	药物
特拉唑嗪	药物
澳泰乐片	药物
克念菌素片	药物
久病亏损	症状
卫生宝丸	药物
桂香祛暑散	药物
外伤如意膏	药物
头孢拉宗	药物
金蓝气雾剂	药物
小青龙合剂	药物
氨肽素硫酸锌片	药物
无目的咀嚼舐唇	症状
孕妇金花胶囊	药物
螺普利	药物
没食子酸丙酯	药物
阿米巴肝脓肿	疾病
复肝康颗粒	药物
氟芬那酸胶囊	药物
麝香抗栓胶囊	药物
唾液钾	检查科目
聚胞苷酸	药物
雪哈灵芝酒	药物
精液气味	检查科目
皮肤干而发红	症状
脑蛋白水解物氯化钠注射液	药物
细辛脑注射液	药物
菜花耳	症状
富马酸氯马斯汀片	药物
小儿脑积水	疾病
结晶磺胺	药物
清热醒脑灵丸	药物
补脾益肠丸	药物
单胺氧化酶	检查科目
心肌营养障碍	症状
节律性刻板重复的不自主运动	症状
人类免疫缺陷病毒抗体12型/P24抗原1型诊断试剂盒酶联免疫法	药物
炎症性腹主动脉瘤	疾病
月泰贴脐片	药物
苦参片	药物
感特灵胶囊	药物
肛门夜间奇痒	症状
果糖二磷酸钠胶囊	药物
注射用氨茶碱	药物
脑脊液生长素	检查科目
盐酸贝尼地平	药物
氧氟沙星滴耳液	药物
盐酸多柔吡星	药物
乳腺康注射液	药物
复方米非司酮片	药物
避瘟散	药物
陈香露白露片	药物
硫马唑	药物
巴比妥	药物
胃粘膜损伤	症状
颅骨纤维异常增生症	疾病
白血病肾损害	疾病
润畅胶囊	药物
甲胎蛋白免放药盒	药物
老年人急性呼吸窘迫综合征	疾病
结核中毒	症状
尿胃蛋白酶原	检查科目
风热疮	疾病
头目晕沉	症状
药品零差价	NoneType
洛度沙胺氨丁三醇	药物
鱼鳞癣样红皮	症状
复方甘草酸单铵S注射液	药物
低分子肝素钠凝胶	药物
羟磷灰石沉积病	疾病
乙酰螺旋霉素	药物
老烂腿	疾病
感冒清热软胶囊	药物
发热伴寒战	症状
安宫止血颗粒	药物
甲磺酸氨氯地平	药物
老年人高血压危象	疾病
天芪消渴片	药物
己糖激酶缺乏症	疾病
扑感片	药物
瞳子高	症状
小肠类癌	疾病
盐酸左氧氟沙星滴眼液	药物
兽咬伤	疾病
叶绿素铜钠胶囊	药物
骨气臌	症状
注射用盐酸尼莫司汀	药物
中毒性休克综合征	疾病
治糜灵泡腾片	药物
前列腺炎	疾病
肥疮	疾病
和胃安眠丸	药物
注射用维库溴铵	药物
三氟哌多	药物
反复肺炎	症状
血气胸	疾病
内科医生	NoneType
过氧苯甲酰红霉素	药物
阴茎异常	症状
十全大补口服液	药物
反复感冒	症状
清咽片	药物
维斯科特-奥尔德里奇综合征	疾病
己酮可可碱片	药物
基质性角膜炎	疾病
鼠咬热	疾病
氨酚美伪滴剂	药物
关节镇痛膏	药物
呋脲苄西林钠	药物
食管瘘	症状
头孢克肟胶囊	药物
麻痹	症状
盐酸左旋咪唑颗粒	药物
肛门周围癌	疾病
碳酸钙甘氨酸胶囊	药物
缺血性肝炎	疾病
急性扁桃体炎	疾病
短棒状杆菌制剂	药物
杀人游戏	NoneType
夫洛非宁	药物
新生儿青紫	疾病
微球菌属	细菌
腺样体炎	疾病
眼敷膏	药物
貂油治裂软膏	药物
口腔粘膜色素沉着	症状
环丙沙星缓释片	药物
羚羊角口服液	药物
硫酸妥布霉素注射液	药物
夜宁冲剂	药物
盐酸拓扑替康	药物
女性生殖道多部位原发癌	疾病
盐酸格拉司琼分散片	药物
间苯三酚注射液	药物
亚叶酸钙氯化钠注射液	药物
倍他米松新霉素乳膏	药物
粪中脂肪抗精子抗体	检查科目
少腹逐瘀丸	药物
止血宁胶囊	药物
异美汀	药物
甲状舌骨囊肿与瘘	疾病
妇炎灵泡腾片	药物
妇女养血丸	药物
疟疾肾病	疾病
暑湿感冒冲剂	药物
妊娠胶乳诊断试剂	药物
盐酸头孢他美酯干混悬剂	药物
关节游走性疼痛，肿胀	症状
复方葡萄糖酸钙口服溶液	药物
抗肌球蛋白抗体	检查科目
网络成瘾	疾病
副醛	药物
茶碱葡胺	药物
特发性股骨头坏死	疾病
睫状体黑色素瘤	疾病
宝珍膏	药物
西伯利亚立克次体斑疹热	疾病
牛痘样水疱病	疾病
多索茶碱片	药物
阿扎他定	药物
叶绿体	NoneType
银翘解毒颗粒	药物
乙型肝炎病毒e抗原诊断试剂盒(放射免疫法)	药物
顽固性高血压	症状
胃良性肿瘤	疾病
肺炎克雷伯氏菌	细菌
海藻酸铝镁颗粒	药物
习惯性髌骨脱位	疾病
生长激素	检查科目
氨苄西林舒巴坦	药物
躯体或颜面某一局部的连续性抽动	症状
氯波必利	药物
氯化钙注射液	药物
奈福泮	药物
缬沙坦片	药物
吗氯贝胺	药物
甲哌卡因	药物
复合氨基酸注射液(18)	药物
消痔软膏	药物
老年人高渗性非酮症糖尿病昏迷	疾病
瘰疬	疾病
人格解体-现实解体综合征	疾病
风湿性关节炎	疾病
外伤性低颅内压综合征	疾病
情感性交叉擦腿症	疾病
氯沙坦钾片	药物
十二指肠引流胰蛋白酶	检查科目
乙型肝炎病毒表面抗原诊断试剂盒(放射免疫法)	药物
红细胞谷胱甘肽还原酶	检查科目
清喉咽冲剂	药物
胫骨压痛	症状
婴儿消食散	药物
排便障碍	症状
主动脉弓综合征视网膜病变	疾病
乌头注射液	药物
前庭大腺囊肿	疾病
尼莫地平软胶囊	药物
无脉症	症状
纳洛酮	药物
鼠神经生长因子	药物
替可克肽	药物
甲哨唑注射液	药物
莫沙必利	药物
变性近视的脉络膜萎缩	疾病
会呼吸的痛	NoneType
意识模糊	症状
恶性血管内皮细胞瘤	疾病
双黄连含片	药物
药物反应性甲病	疾病
盐酸左西替利嗪分散片	药物
参茸鹿胎膏	药物
腿前内侧出现感觉异常	症状
益髓颗粒	药物
豹骨活络丸	药物
喉痈	疾病
胫骨后唇骨折	疾病
脑得生袋泡剂	药物
美国	NoneType
美索巴莫胶囊	药物
唾液睾酮	检查科目
注射用硫酸多粘菌素B	药物
枯草杆菌肠球菌二联活菌肠溶胶囊	药物
姜竭补血合剂	药物
血热	症状
失血过多	症状
盐酸伪麻黄碱缓释片	药物
三尖瓣闭锁不全	疾病
洛伐他汀片	药物
甲亢灵片	药物
小儿急性血行播散型肺结核	疾病
说话带鼻音	症状
利咽含片	药物
阿司匹林泡腾片	药物
赤痢	疾病
蜜炼川贝枇杷膏	药物
脉络膜缺血	疾病
鼻子颜色苍白	症状
首乌补肾酒	药物
子宫破裂	疾病
食管腔梗阻	症状
肺嗜酸性粒细胞浸润症	疾病
吟诗样语言	症状
金褐霉素	药物
正柴胡饮胶囊	药物
固本咳喘胶囊	药物
都梁软胶囊	药物
冠心生脉口服液	药物
水、钠潴留性肥胖症	症状
结节性硬化症	疾病
病毒性肝炎	疾病
肾安胶囊	药物
阿尔茨海默病	疾病
中心静脉压偏高	症状
肺炎球菌脑膜炎	疾病
海龙胶	药物
喷替酸钙钠	药物
抑肽酶氯化钠注射液	药物
骨折	疾病
色素紫癜性皮炎	疾病
小儿软骨营养障碍-血管瘤综合征	疾病
优克龙	药物
无水葡萄糖	药物
胸腺肽	药物
尿道口有白膜形成	症状
颅咽管瘤	疾病
葛根芩连微丸	药物
保和液	药物
克洛己新干混悬剂	药物
葡萄糖酸钠	药物
复方感冒胶囊	药物
脊髓亚急性联合变性	疾病
复方磺胺间甲氧嘧啶片	药物
先天性胆管囊状扩张	疾病
前列地尔尿道栓	药物
气血虚弱	症状
陈夏六君子丸	药物
海马舒活膏	药物
胆囊平滑肌肉瘤	疾病
参芪二仙片	药物
湿毒清片	药物
香连化滞片	药物
稀盐酸溶液	药物
颈部可前屈，怕仰伸	症状
脑干肿瘤	疾病
消风止痛宁胶囊	药物
婴儿需要较大量的维生素B6	症状
仙桃草膏	药物
胍立莫司	药物
口服双歧杆菌活菌散剂	药物
乳房猪囊尾蚴病	疾病
垂体卒中	疾病
抗卵巢抗体阳性	症状
二十五味阿魏胶囊	药物
华蟾素口服液	药物
需钠弧菌	细菌
睾丸炎	疾病
氟尿苷	药物
泛硫乙胺片	药物
磺胺林	药物
成釉细胞纤维瘤	疾病
咽部狼疮	疾病
有机磷中毒	症状
血栓扩展	症状
小儿肺栓塞	疾病
鱼胆中毒	疾病
锰中毒	疾病
断血流泡腾片	药物
强肝丸	药物
复方氯丙那林鱼腥草素钠片	药物
阿仑膦酸钠	药物
维生素A胶丸	药物
氢溴酸依他佐辛注射液	药物
龙胆泻肝片	药物
无名指不明原因疼痛	症状
精制冠心颗粒	药物
肤痔清软膏	药物
益肾兴阳胶囊	药物
碱性磷酸酶增高	症状
注射用枸橼酸钠	药物
碘苷滴眼液	药物
扁桃酸栓	药物
香连胶囊	药物
正常眼压性青光眼	疾病
美息伪麻拉明分散片	药物
复方血藤药酒	药物
虚火	症状
皮肤的非干酪性肉芽肿	症状
弱精	疾病
眼旋转	症状
无胆色素尿性黄疸综合征	疾病
再生障碍性贫血	疾病
膀胱容量的减少	症状
开胃理脾丸	药物
复方南板蓝根颗粒	药物
腮腺隙感染	疾病
眼前冒火花或眼前闪光	症状
消旋山莨菪碱片	药物
先天性风疹	疾病
丹鹿通督片	药物
亚油酸维生素E胶丸/二维芦丁片	药物
天麦消渴片	药物
盐酸组氨酸	药物
腱病	疾病
化痔片	药物
脑血管病	疾病
普鲁卡因	药物
苍耳中毒	疾病
龙蛾酒	药物
卡托普利滴丸	药物
注射用头孢地秦钠	药物
骨髓的发育异常	症状
胆囊结石	疾病
腹部型肥胖	症状
二硫化碳中毒	疾病
粪便带绿色	症状
伤口感染	症状
红药片	药物
复方鱼腥草片	药物
益母草流浸膏	药物
胃粘膜呈萎缩性改变	症状
小柴胡泡腾片	药物
五加片	药物
腹股沟肉芽肿	疾病
血清结合球蛋白	检查科目
糖链抗原724	检查科目
十五味赛尔斗丸	药物
麝香草酚	药物
肾小球旁器增生	症状
兰索拉唑片	药物
外阴烧灼刺激感	症状
赤霉素	药物
雪上一枝蒿总生物碱	药物
复方保泰松鸡血藤片	药物
通心络片	药物
五黄膏	药物
阴囊上有白色小疙瘩	症状
角膜灼伤刮伤	症状
语音震颤增强	症状
部分性发作	疾病
肺部啰音	症状
酒精中毒	疾病
达替米星	药物
肠泰合剂	药物
血栓调节蛋白活性	检查科目
烧伤休克	疾病
强迫性神经官能症	症状
促菌生	药物
桑椹冲剂	药物
色羟丙钠滴鼻液	药物
低眼压性青光眼	疾病
益胃口服液	药物
萘普生	药物
肺纤维化	疾病
神曲茶	药物
肌病肾病性代谢综合征	疾病
马来酸麦角新碱	药物
泛酸钙片	药物
替硝唑注射液	药物
颌周蜂窝织炎	疾病
颈交感链受累	症状
维生素E烟酸酯	药物
产后手指痛	症状
易于产生病理嫉妒信念	症状
不宁腿综合征	症状
室间隔膜部瘤	疾病
角鲨烯胶丸	药物
盐酸哌仑西平	药物
樟脑	药物
暴发性痛	症状
肝泰颗粒	药物
通窍耳聋丸	药物
柴连口服液	药物
老年人运动神经元病	疾病
注射用盐酸伊达比星	药物
脂质沉积症	症状
川贝止咳露	药物
涎腺放线菌病	疾病
拉呋替丁	药物
蒙脱石散剂	药物
蟾酥镇痛巴布膏	药物
胸水检查	检查科目
阴茎短	症状
少年儿童葡萄膜炎	疾病
自身免疫性甲状腺疾病相关肾病	疾病
右美托咪定	药物
头孢甲肟	药物
奥硝唑栓	药物
不全流产	症状
头癣	疾病
阴道裂伤	症状
复方首乌补液	药物
阴道斜隔	疾病
荔花鼻窦炎片	药物
颈椎小关节创伤性退变性关节炎	疾病
心脑舒颗粒	药物
四正丸	药物
喜树碱软膏	药物
百咳宁片	药物
羧甲基半胱氨酸泡腾散	药物
舍曲林	药物
多肌腱末端病	疾病
周围组织灌注不良	症状
猴菇片	药物
益元黄精糖浆	药物
小儿疳积	症状
胸部大片斑块	症状
中枢性发热	症状
小儿格林巴利综合症	疾病
七味葡萄散	药物
痔炎消颗粒	药物
扁蕾颗粒	药物
精液稀	症状
西尼地平	药物
百令颗粒	药物
愈裂贴膏	药物
牛肺表面活性提取物	药物
中毒性细菌性痢疾	疾病
五根油丸	药物
十全大补丸	药物
痛经宁颗粒	药物
眦部缺损或眦缺损	症状
青少年及小儿卵巢肿瘤	疾病
奥替溴铵	药物
腹满	症状
消炎止咳片	药物
益肝乐胶囊	药物
注射用两性霉素B	药物
盐酸吡多胺	药物
包涵体肌炎与遗传性包涵体肌病	疾病
黄藤素注射液	药物
地匹福林	药物
导赤丹	药物
低血容量休克	症状
克感利咽口服液	药物
注射用尼麦角林	药物
定位体征	症状
芪风颗粒	药物
积聚	疾病
急性闭角性青光眼	疾病
口唇渗液	症状
IRT理论	NoneType
叶间裂常呈弧形下坠	症状
身体变形障碍	症状
太阳	NoneType
治疗用卡介苗	药物
异色性虹膜睫状体炎	疾病
素炒茄子	NoneType
下肢血压偏低	症状
小儿军团病肾病	疾病
陆氏润字丸	药物
鱼金注射液	药物
生长痛	疾病
外阴银屑病	疾病
铁锈色痰	症状
盐酸利多卡因	药物
子痫症状	症状
抗感冒颗粒(低糖型)	药物
造影剂肾病	疾病
米格列醇	药物
江南卷柏片	药物
地西泮	药物
感冒止咳胶囊	药物
下肢水肿	症状
竹节脊柱	症状
眼睑湿疹	疾病
依匹唑	药物
煤尘或胆固醇结晶的黏痰	症状
小儿颅内肿瘤	疾病
光泽苔藓	疾病
玉泉丸	药物
心境不良	症状
子宫性闭经	症状
爆裂性眼眶骨折	疾病
利儿康口服液	药物
盐酸阿米洛利片	药物
指（趾）麻木	症状
石榴补血糖浆	药物
髋内翻	症状
多骨纤维发育不良	疾病
皮肤为金属颜色或石板灰色	症状
忽略症	疾病
糖多孢菌属	细菌
口舌生疮	症状
奥拉西坦	药物
头昏想睡觉	症状
氧化锌油	药物
先天性血管萎缩性皮肤异色症	疾病
龋齿宁含片	药物
安胃疡胶囊	药物
肺宁丸	药物
利多氟嗪	药物
呼吸气为蒜臭味	症状
复方田七胃痛胶囊	药物
麝香跌打风湿膏	药物
活血解毒丸	药物
神康宁丸	药物
地中海贫血	疾病
儿童清肺丸	药物
子嗽	疾病
人工泪液	药物
醋酸氟氢松软膏	药物
异烟肼	药物
颈动脉海绵窦瘘	疾病
无肌病性皮肌炎	疾病
心脏排血受阻	症状
盐酸洛美沙星	药物
胸膜炎	疾病
氨咖黄敏胶囊	药物
重组牛碱性成纤维细胞生长因子外用凝胶	药物
嗜酸细胞增加	症状
百令胶囊	药物
小肠腺瘤	疾病
冻干重组人脑利钠肽	药物
注射用乌司他丁	药物
乌芪胶囊	药物
小肠血管瘤	疾病
盐酸洛美沙星注射液	药物
色素性静脉旁视网膜脉络膜萎缩	疾病
肛门尖锐湿疣	疾病
阿可乐定	药物
紫椒癣酊	药物
巨人症与肢端肥大症	疾病
标准碳酸氢盐	检查科目
鹅口疮	疾病
烧心	症状
横结肠扭转	疾病
病理性偷窃	症状
颅骨巨细胞瘤	疾病
菊蓝抗流感颗粒	药物
曲克芦丁羟丙茶碱片	药物
安络痛片	药物
次水杨酸铋	药物
热结节	症状
小儿其他沙门菌感染	疾病
腹痛伴恶心、呕吐	症状
酸雾	NoneType
乌洛托品	药物
褥疮	疾病
原发性中枢神经系统淋巴瘤	疾病
产后血瘀	疾病
右雷佐生	药物
胸降主动脉动脉瘤	疾病
新肤螨灵软膏	药物
水冲脉	症状
愈美分散片	药物
冠心苏合咀嚼片	药物
小儿先天性侏儒痴呆综合征	疾病
三硅酸镁	药物
老年男性乳房无痛性肿块	症状
跌打生骨颗粒	药物
甲麦角林	药物
肾上腺皮质良性男性化现象	症状
跌打活血散	药物
单硝酸异山梨酯胶丸	药物
鹿尾补肾丸	药物
肚脐痒	症状
双胎静脉吻合	症状
利福定胶囊	药物
清血八味胶囊	药物
浅棕色斑点	症状
维酶素	药物
原发性心脏肿瘤	疾病
排便不尽感	症状
尿钾	检查科目
脊疳	疾病
柏子养心丸	药物
拟杆菌	细菌
精液量	检查科目
蛇胆川贝散	药物
胆热	疾病
婴幼儿化脓性淋巴结炎	疾病
分泌过多性青光眼	疾病
外阴象皮肿	疾病
小儿牛黄颗粒	药物
血小板型假性血管性血友病	疾病
汗证	疾病
甲钴胺注射液	药物
贯防感冒片	药物
轻度精神发育迟滞	症状
革兰阳性球菌和革兰阴性杆菌性巩膜炎	疾病
益气六君丸	药物
固肾安胎丸	药物
盐酸地尔硫卓注射液	药物
间歇性头晕	症状
金莲胃舒片	药物
羟基脲胶囊	药物
盐酸多沙普仑注射液	药物
抗胰岛素受体抗体	检查科目
防己关节丸	药物
复方木尼孜其颗粒	药物
注射用二丁酰环磷腺苷钙	药物
瘀血头痛	疾病
纵隔非霍奇金淋巴瘤	疾病
喷托维林氯化铵糖浆	药物
维生素AD软胶囊	药物
颞下颌关节病	疾病
胱氨酸储积症	症状
四君子颗粒	药物
氢溴酸加兰他敏片	药物
截疟七宝丸	药物
常通舒颗粒	药物
头孢曲松	药物
侵袭性婴儿纤维瘤病	疾病
水咳	症状
老年人骨质疏松	疾病
细菌性角膜溃疡	疾病
血宁颗粒	药物
Mirizzi综合征	疾病
甘露醇烟酸酯片	药物
康诺尔立克次体斑疹热	疾病
鼻乳头状瘤	疾病
卵巢浆液性肿瘤	疾病
镰形红细胞	检查科目
螺旋霉素胶囊	药物
谷氨酸钾注射液	药物
肱骨外髁骨折	疾病
氢溴酸高乌甲素注射液	药物
灵芪加口服液	药物
注射用盐酸氨溴索	药物
血红蛋白D病	疾病
小儿肾性贫血	疾病
头孢匹罗	药物
溴苯那敏	药物
乙酰乌头碱	药物
结节性脂肪坏死	疾病
晶状体青光眼斑	症状
贝克痣	疾病
气道变窄	症状
注射用氨苄西林钠氯唑西林钠	药物
芪龙胶囊	药物
免疫球蛋白A放免药盒	药物
皮肤平滑肌瘤	疾病
克林霉素磷酸酯氯化钠注射液	药物
葡萄溏注射液	药物
九气心痛丸	药物
大黄虫丸	药物
雷公藤提取物	药物
百科	NoneType
甲磺酸酚妥拉明	药物
复方猴头颗粒	药物
十味活血丸	药物
鼻子红血丝	症状
小儿鼻炎	疾病
上颌后缩	疾病
肺血流量很少	症状
三甲双酮	药物
克痢痧胶囊	药物
胸廓异常	症状
阿米三嗪萝巴新片	药物
尿三杯试验	检查科目
髌股关节软骨损伤	疾病
髌骨骨裂	症状
眼球不能随意动	症状
杜仲降压片	药物
三黄珍珠膏	药物
外阴中肾管囊肿	疾病
胃康灵颗粒	药物
睡眠时睑闭合不全	症状
胸膜肥厚	症状
云胃宁胶囊	药物
泛昔洛韦缓释胶囊	药物
脑栓康复胶囊	药物
环丙沙星	药物
盐酸川芎嗪注射液	药物
盐酸关附甲素	药物
清肝利胆口服液	药物
板蓝根冲剂	药物
白蛋白放免药盒	药物
先天性胃壁肌层缺损	疾病
诺氟沙星锌	药物
羚羊角滴丸	药物
常现丝虫病	疾病
挤压综合征	疾病
单纯骨折	症状
妥卡尼	药物
肝功能异常	症状
清喉咽颗粒	药物
痢疾样大便	症状
尼兹诺夫综合征	疾病
止痛紫金丸	药物
男性性早熟	疾病
手指屈肌腱鞘炎	疾病
乙型副伤寒菌诊断菌液	药物
口腔颌面部软组织切割伤	疾病
先天性喉闭锁	疾病
骨髓巨核细胞数和分类	检查科目
氨甲环酸片	药物
胎粪性便秘	疾病
抗流行性乙型脑炎病毒IgM抗体	检查科目
肢端易发生不易控制的足癣感染	症状
脉络膜血管瘤	疾病
小儿星形细胞瘤	疾病
甘油三酯试剂盒(酶比色法)	药物
扎来普隆分散片	药物
人巨细胞病毒抗体	检查科目
动脉导管未闭	疾病
丹皮酚磺酸钠	药物
反向搏动	症状
解毒胶囊	药物
牙齿小且无光泽	症状
更昔洛韦胶囊	药物
消渴灵片	药物
西咪替丁口服乳	药物
磷酸咯萘啶	药物
氯硝柳胺	药物
阿魏酸钠注射液	药物
十二味痹通搽剂	药物
海藻玉壶汤	药物
小儿原发型肺结核	疾病
性兴奋障碍	疾病
奥沙利铂甘露醇注射液	药物
聚乙二醇电解质散剂	药物
想念是会呼吸的痛	NoneType
八味肉桂胶囊	药物
消渴丸	药物
小管毒性病变	症状
六合氨基酸颗粒	药物
上呼吸道粘膜刺激症状	症状
热入血室	疾病
美羧伪麻胶囊	药物
喝酒后胃疼	症状
目光呆滞	症状
霉菌性阴道炎	疾病
肝豆状核变性伴发的精神障碍	疾病
思念是一种病	NoneType
脉络宁口服液	药物
新生儿喉喘鸣	疾病
骨痛灵酊	药物
雪莲药酒	药物
肌苷	药物
胸椎黄韧带骨化症	疾病
皮肤出血点	症状
消渴病	疾病
五仁醇软胶囊	药物
对乙酰氨基酚栓	药物
三臣胶囊	药物
变色镜片	NoneType
肌性肌无力	症状
四季三黄胶囊	药物
小腿或前臂间隙综合征	症状
玫瑰花糖膏	药物
白脉软膏	药物
新胂凡纳明	药物
诺氟沙星胶囊	药物
棕榈氯霉素(B型)片	药物
大量羊水吸入	疾病
食管对称性膨大	症状
眼球运动偏斜扭转	症状
内踝下区域疼痛肿胀	症状
皮肤发红	症状
益气养血补酒	药物
杞菊地黄丸	药物
球孢子菌病	疾病
注射用头孢米诺钠	药物
肝净注射液	药物
热痹	疾病
滇桂艾纳香胶囊	药物
小儿卡斯钦-贝克病	疾病
脑脊液细胞计数	检查科目
慢性化脓性腮腺炎	疾病
右旋布洛芬	药物
痫症镇心丸	药物
糖链抗原199	检查科目
生长激素分泌过少	症状
补血调经片	药物
多发性斑状色素沉着症	疾病
如意定喘丸	药物
斑蝥酸钠	药物
口鼻周围发绀	症状
稀氨溶液	药物
小儿牛黄清心散	药物
小儿脑肿瘤	疾病
小儿热带巨脾综合征	疾病
胆道肿瘤	疾病
苜蓿花叶病毒	病毒
乙胺嘧啶片	药物
醋氨己酸锌胶囊	药物
感冒退热口服液	药物
复方三七补血片	药物
尼麦角林片	药物
青柏洁身洗液	药物
尿感宁冲剂	药物
Maffucci综合征	疾病
小儿疳痢	疾病
疗癣卡西甫散	药物
开角型青光眼	疾病
乙酰吉他霉素干混悬剂	药物
唾液链球菌	细菌
黄热病	疾病
慢惊风	疾病
骨产道异常性难产	疾病
葡萄胎	疾病
口咽部水疱状损害	症状
肺炎衣原体感染	疾病
绿脓杆菌性角膜溃疡	疾病
巨细胞病毒感染	疾病
腹部创伤	疾病
粉尘	NoneType
表皮葡萄球菌	细菌
肾上腺素能依赖性尖端扭转性室性心动过速	疾病
脑沟变宽	症状
泛昔洛韦片	药物
喜炎平注射液	药物
额颞痴呆	疾病
穿心莲注射液	药物
布洛伪麻缓释片	药物
加替沙星	药物
十二指肠胃反流及胆汁反流性胃炎	疾病
注射用盐酸吡柔比星	药物
索尼芬新	药物
三七止血咀嚼片	药物
皮肤穿入性毛囊和毛囊周角化病	疾病
小儿维生素B12选择性吸收障碍综合征	疾病
故宫	NoneType
七维牛磺酸口服溶液	药物
头孢拉定胶囊	药物
肺动脉狭窄	症状
特发性低促性腺激素性性腺功能减退症	疾病
消肿片	药物
布洛伪麻分散片	药物
慢性肾上腺皮质功能减退症	疾病
双肾皮质变薄	症状
阿司待因片	药物
大黄通便冲剂	药物
严重肝病引起获得性凝血因子异常	疾病
动脉造影异常	症状
遗传性凝血因子Ⅺ缺乏	疾病
托吡卡胺眼药水	药物
清解片	药物
碳酸钙咀嚼片	药物
硝酸甘油贴片	药物
复方枸橼酸铁铵糖浆	药物
他克林	药物
外伤性低位截瘫	症状
蟾乌巴布膏	药物
高血糖素	药物
胚宝胶囊	药物
假性高血压	疾病
长春新碱	药物
匹莫林片	药物
复胃散片	药物
眼睑痉挛-口下颏部肌张力障碍	疾病
三氯噻嗪	药物
枫蓼冲剂	药物
精子增多症	疾病
复方百部止咳颗粒	药物
桂林西瓜霜含片	药物
参坤养血颗粒	药物
扎来普隆胶囊	药物
口腔颌面部软组织刺伤	疾病
人类免疫缺陷病毒抗体HIV1/2诊断试剂盒胶体金法	药物
钟南山	NoneType
盐酸丙哌维林	药物
男性生殖腺机能减退症	疾病
烧伤科	医学专科
糖链抗原242	检查科目
尼扎替丁	药物
下颈椎不稳症	疾病
脓疱型银屑病	疾病
丙酯注射液	药物
肾舒冲剂(无糖型)	药物
痰咳清片	药物
耳冻伤	症状
灰黄霉素胶囊	药物
死精症	疾病
罗布麻降压片	药物
氯雷伪麻缓释胶囊	药物
小儿扶脾颗粒	药物
收缩期反流性杂音	症状
醋酸可的松	药物
羚羊感冒胶囊	药物
铁树	NoneType
头孢孟多	药物
脐带过短或相对过短	症状
生脉颗粒(党参方)	药物
系统性红斑狼疮	疾病
左氧氟沙星葡萄糖注射液	药物
连柏烧伤膏	药物
髓性多汗症	疾病
口服酪酸梭菌活菌胶囊	药物
清肺抑火丸	药物
心理弹性	NoneType
打呼噜	症状
呋噻米注射液	药物
眶脑膜瘤	疾病
灵芝益寿胶囊	药物
安乃近片	药物
肠麻痹	症状
胆石片	药物
两侧颊部及颞部凹入	症状
生理性震颤	症状
胸椎后纵韧带骨化症	疾病
盐酸伊立替康	药物
九维片	药物
巨大颅骨缺损	症状
鼻端肥大	症状
胃液显微镜检查	检查科目
脑灵素片	药物
止血宁片	药物
大黄庶虫丸	药物
熊胆肝泰	药物
系统性红斑狼疮性巩膜炎	疾病
指甲干瘪	症状
月经前水肿	症状
清晨或上午头痛	症状
鼻尖上翘呈马鞍状	症状
野外作业	NoneType
血液尿素氮与肌酐比值	检查科目
恶臭假单胞菌	细菌
闪回	症状
辣根过氧化酶标记免疫球蛋白结合物	药物
胸腹水纤维蛋白降解产物	检查科目
乳果糖口服溶液	药物
洛伐他汀分散片	药物
烧伤后急性呼吸窘迫综合征	疾病
脑脊液谷氨酰胺	检查科目
益心舒胶囊	药物
芪枣冲剂	药物
迁延性肺嗜酸粒细胞浸润症	疾病
勒夫勒心内膜炎	疾病
升主动脉瘤	疾病
先天性副肌强直症	疾病
鳞屑	症状
眼球内炎	疾病
参术儿康糖浆	药物
半夏露颗粒	药物
阿氯米松	药物
大便干结呈算盘珠状	症状
五维他口服溶液	药物
吸附无细胞百日咳白喉破伤风联合疫苗	药物
芬布芬	药物
磷酸肌酸钠	药物
合成天麻素片	药物
清热凉血膏	药物
眼球穿孔伤	疾病
金龙胆草浸膏片	药物
感冒解热颗粒	药物
强力天麻杜仲丸	药物
小儿解感颗粒	药物
支气管结核	疾病
速克感冒片	药物
血清病和血清病样反应	疾病
庆大霉素普鲁卡因维B12颗粒	药物
眠安宁	药物
腮腺囊肿	疾病
白天嗜睡夜间失眠	症状
眼部感染	症状
食欲缺乏	症状
面部闪电疼痛	症状
冠心苏合丸	药物
金胆片	药物
野菊花栓	药物
金锁昆都尔片	药物
丁苯羟酸	药物
血浆黏度	检查科目
依达拉奉注射液	药物
耳源性眩晕	症状
葡萄糖酸锌口服溶液	药物
穿山甲	NoneType
年轻女性心悸胸闷	症状
流感病毒	病毒
多形红斑	疾病
胰岛细胞破坏	症状
天王补心丹	药物
硫酸特布他林注射液	药物
铜绿假单胞菌性角膜炎	疾病
恒定性外斜视	疾病
肝硬化腹水	疾病
透明血管型	症状
家禽	NoneType
脑灵片	药物
颈部缺血性跳痛	症状
寒水石二十一味散	药物
头顶重压发紧	症状
小儿乙型肝炎病毒相关肾炎	疾病
龙血竭胶囊(肠溶)	药物
二十五味珍珠丸	药物
人工麝香	药物
索利那新	药物
胃粘膜素	药物
暴发性紫癜	疾病
小儿类白血病反应	疾病
心前区隐痛	症状
沙格雷酯	药物
通脉口服液	药物
盐酸赖氨酸氯化钠注射液	药物
谷丙甘氨酸片	药物
耻区肿块	症状
意大利蝗痘病毒	病毒
十二指肠腺癌	疾病
洁尔阴泡腾片	药物
茵栀益肝颗粒	药物
肝血管瘤	疾病
加味龟龄集酒	药物
更年乐片	药物
司他夫定散	药物
囊性坏死	症状
吉米沙星	药物
温肾苏拉甫片	药物
原发性卵巢类癌综合征	疾病
薄荷尿素贴膏	药物
前房积血	疾病
碱性胚胎蛋白	检查科目
复方磷酸氢钠片	药物
婴儿骨皮质增生症	疾病
锁仙补肾口服液	药物
通关散	药物
消化道憩室病	疾病
吲哚美辛控释胶囊	药物
比卡鲁胺片	药物
头部震颤	症状
军刀综合征	疾病
巴曲酶注射液	药物
丙型肝炎病毒抗体诊断试剂盒(酶联免疫法)	药物
制药业引起的皮肤病	疾病
小儿人类疱疹病毒6，7，8型感染性疾病	疾病
氨己烯酸	药物
枳术颗粒	药物
基因融合	症状
寰椎横突肥大	疾病
创伤性气管及主支气管损伤	疾病
吗多明片	药物
二巯丙醇注射液	药物
尼莫司汀	药物
肥大性骨关节病	疾病
依替磷酸二钠片	药物
十二指肠重复畸形	疾病
洋葱伯克霍尔德菌	细菌
氢氧化镁	药物
盐酸索他洛尔	药物
咽麻痹	疾病
足跟瘀斑	疾病
制金柑丸	药物
双嘧达莫氯化钠注射液	药物
清浊祛毒丸	药物
伪膜性肠炎	疾病
婴儿黑矇性痴呆	疾病
双扑伪麻颗粒	药物
日本血吸虫病	疾病
外阴黑色素瘤	疾病
克咳胶囊	药物
儿茶酚胺	检查科目
冠心膏	药物
葡萄糖酸氯己定贴	药物
肾性脑病	疾病
维他利匹特	药物
“猿手”畸形	症状
盐酸美司坦	药物
续断壮骨胶囊	药物
硬化剂治疗引起的食管损害	疾病
多发性肌炎	疾病
木香理气片	药物
盐酸羟苄唑	药物
骶尾部急性脓肿	症状
频繁呕吐及便秘	症状
婴儿及儿童期癫痫及癫痫综合征	疾病
膝关节积液	症状
曲伏前列素	药物
全血铬	检查科目
急性呼吸困难	症状
溃疡分枝杆菌感染	疾病
子宫收缩乏力	疾病
腰酸	症状
桔红化痰片	药物
巨细胞动脉炎	疾病
替加氟	药物
杏灵颗粒	药物
胃溃宁片	药物
黄斑前膜	疾病
晚霞样或夕照样眼底	症状
脑脊液免疫球蛋白	检查科目
壮西六味散	药物
转移性小肠肿瘤	疾病
新生儿肛门和直肠畸形	疾病
妇科金丹	药物
小儿先天性甲状腺功能减低症	疾病
满山白胶囊	药物
十味乳香胶囊	药物
肾小管间质性肾炎葡萄膜炎综合征	疾病
惊风	疾病
沉香化滞丸	药物
枫蓼肠胃康颗粒	药物
小儿病毒感染性口炎	疾病
婴儿头大	症状
食管蠕动功能减弱	症状
六灵含片	药物
亚油酸维生素E胶丸二维芦丁片	药物
金石清热颗粒	药物
尺管综合征	疾病
埃索美拉唑镁肠溶片	药物
异戊巴比妥钠	药物
噻苯达唑	药物
癫狂马宝散	药物
免疫介导性肾脏病	疾病
外耳道肿瘤	疾病
外阴血管瘤	疾病
治痢片	药物
碱性磷酸酶染色	检查科目
乳酸诺氟沙星注射液	药物
罗己降压片	药物
呋布西林钠	药物
盆炎清栓	药物
葆宫止血颗粒	药物
足踝部光滑圆形的包块	症状
结肠血管发育不良	症状
休克	疾病
猪传染性胃肠炎病毒	病毒
盐酸地尔硫卓缓释胶囊	药物
吗替麦考酚酯胶囊	药物
复方枇杷叶膏	药物
脊柱破坏	症状
成骨不全	疾病
短杆菌肽	药物
干性脂溢	症状
吉法酯	药物
十二指肠憩室	疾病
会厌炎	疾病
肝性脑病	疾病
双侧手足徐动	症状
胃内异物	疾病
成团泛菌	细菌
毛细血管扩张症	症状
麻疹	疾病
葛根苓连片	药物
开胃消食口服液	药物
注射用加替沙星	药物
注射用氨苄西林钠舒巴坦钠	药物
阿米替林	药物
漆所致皮肤病	疾病
颞骨隆起	症状
播散性黄瘤伴尿崩症	疾病
毒毛花苷K注射液	药物
鼻腔及鼻窦异物	疾病
耳外伤	疾病
女性假两性畸形	疾病
排石通淋口服液	药物
新生化冲剂	药物
农民肺	疾病
酚磺乙胺葡萄糖注射液	药物
压力和体位性多汗	症状
尿塞通片	药物
蒲公英冲剂	药物
亚急性硬膜外血肿	疾病
新生儿臂丛神经麻痹	疾病
色素性口周红斑	疾病
蓝色视野缺损	症状
死精子过多	症状
硝呋太尔片	药物
盐酸班布特罗颗粒	药物
新生儿皮肤硬肿	症状
带状疱疹样外观	症状
阳强	疾病
维生素B6	药物
指甲异常	症状
盐酸氮卓斯汀	药物
凉结节	症状
双上眼睑的水肿性紫红色斑	症状
硫酸沙丁胺醇雾化吸入溶液	药物
右丙亚胺	药物
复方肝浸膏糖浆	药物
氧氟沙星乳膏	药物
回春酒	药物
反复生殖器溃疡	症状
三碘甲状腺原氨酸摄取率	检查科目
米根霉	细菌
盐酸哌替啶片	药物
奈多罗米	药物
抗骨增生丸	药物
十味扶正颗粒	药物
次硝酸铋片	药物
乙胺嘧啶	药物
胎盘植入	症状
温虐	疾病
茴香脑	药物
脑衰弱综合征	症状
慢性舌扁桃体炎	疾病
古汉养生颗粒	药物
口腔疾病	疾病
椎管内转移性肿瘤	疾病
神经性耳鸣	疾病
右苯丙胺	药物
内消瘰疬丸	药物
心跳很乱	症状
口、眼、生殖器损害	症状
掌跖角化过度	症状
奔马律心音	症状
步态异常	疾病
非诺贝特微粉颗粒	药物
口角炎	疾病
非甲状腺性的病态综合征	疾病
寒泻片	药物
交叉注视	症状
硫酸庆大霉素胶囊	药物
补肾填精丸	药物
子宫恶性中胚叶混合瘤	疾病
宁神补心片	药物
回盲瓣功能不全	症状
椎间盘钙化症	疾病
颈部僵硬	症状
小儿结节性硬化症	疾病
重组人胰岛素	药物
复方苯海拉明搽剂	药物
老年人肝硬化	疾病
消化道狭窄	症状
新冠工作室	NoneType
输卵管积水	疾病
八味痛经片	药物
色素性青光眼	疾病
中风	疾病
肛泰	药物
硫化氢中毒	疾病
马钱子散	药物
加味藿香正气软胶囊	药物
小脑幕脑膜瘤	疾病
原发性巨球蛋白血症	疾病
保心宁胶囊	药物
胆囊类癌	疾病
疣状血管瘤	疾病
那他霉素滴眼液	药物
清喉散	药物
甘羟铝	药物
氟甲睾酮	药物
血清纤维结合蛋白	检查科目
心源性休克	疾病
香冰祛痛气雾剂	药物
达唑氧苯	药物
可乐定	药物
复方酚咖伪麻胶囊	药物
东莨菪碱贴片	药物
先天性感觉性神经病	疾病
睾丸萎缩	症状
参茸补血酒	药物
先天性支气管囊肿	疾病
胃膜素胶囊	药物
糖尿病	疾病
室上性心律失常	症状
三维B片	药物
爱普列特	药物
口酸伴有口苦烧心	症状
感冒灵颗粒	药物
先天性巨结肠	疾病
元胡止痛分散片	药物
仰卧呼吸	症状
盐酸阿夫唑嗪	药物
银黄口服液	药物
洛索洛芬钠颗粒	药物
米格来宁注射液	药物
肋骨融合	症状
肝气郁结	症状
皮肤黏膜苍白	症状
复方藤果痔疮栓	药物
吉非罗齐片	药物
忘性大	症状
获得性高脂蛋白血症	疾病
盐酸贝那普利片	药物
注射用低分子量肝素钠	药物
小儿乳糜泻	疾病
黄曲霉	NoneType
双料喉风含片	药物
萘普待因片	药物
双黄连泡腾片	药物
血管性痴呆	疾病
羊痘病毒	病毒
产道扁平型狭窄	症状
肾损害	症状
皮肤纤维瘤	疾病
环吡酮胺	药物
注射用盐酸林可霉素	药物
垂体后叶注射液	药物
中风回春片	药物
复方茶碱甲麻黄碱片	药物
二巯丁二酸	药物
大川芎口服液	药物
肝积水	症状
小儿急性小脑性共济失调	疾病
盐酸奥布卡因滴眼液	药物
尿胆原	检查科目
鼻肿瘤	疾病
上升岛链霉菌	细菌
门冬氨酸钾镁木糖醇注射液	药物
玉叶解毒糖浆	药物
甲硝唑芬布芬胶囊	药物
驱毒养颜口服液	药物
小儿清热宁颗粒	药物
氨酚曲麻片	药物
虹膜睫状体炎	疾病
洋参保肺口服液	药物
复方四环素片	药物
盐酸胺碘酮胶囊	药物
鼻溢液	症状
下腰椎不稳症	疾病
小儿感冒散	药物
尿赤	症状
卵巢黏液性肿瘤	疾病
全腹痛	症状
食管痉挛	症状
原发性十二指肠恶性淋巴瘤	疾病
眼睑闭合不全	疾病
止嗽青果合剂	药物
脊髓神经鞘瘤	疾病
热射病	疾病
痰咳净	药物
盐酸氯丙那林	药物
咽喉干燥充血	症状
产妇颈背酸痛	症状
清眩治瘫丸	药物
普乐安	药物
文学	NoneType
注射用尿促性素	药物
氨酚柴胡注射液	药物
视力常呈雾状模糊感	症状
前列腺特异抗原免放药盒	药物
盐酸美沙酮口服液	药物
手指舞	NoneType
耳痒	症状
急性肠系膜上静脉血栓形成	疾病
海藻糖酶缺乏	症状
福来君	药物
血压波动大	症状
尿沉渣12小时计数	检查科目
假笑	症状
三余神曲	药物
弱视眼的拥挤现象	症状
小儿锥体功能不良综合征	疾病
老年人类风湿性关节炎	疾病
人知降糖胶囊	药物
肌束震颤	症状
单眼双下转肌麻痹	疾病
大便不成形	症状
RhD血型定型试剂(单克隆抗体IgM)	药物
下腹局部疼痛	症状
阿尔茨海默病性痴呆	疾病
卡络磺钠	药物
温热	疾病
戊聚糖多硫酸酯	药物
蛇胆姜粒	药物
长春宝丸	药物
腹主动脉腔静脉瘘	疾病
六甲蜜胺片	药物
脓窠疮	疾病
锡尘肺	疾病
檀香清肺二十味丸	药物
年龄相关性白内障	疾病
氟罗沙星胶囊	药物
副伤寒	疾病
垂体瘤	疾病
小儿葡萄状肉瘤	疾病
密螺旋体活动试验	检查科目
注射用头孢拉定	药物
镇咳宁滴丸	药物
肺部转移	症状
保胃胶囊	药物
脱发性毛囊炎	疾病
贝诺酯分散片	药物
结核性膀胱挛缩	疾病
海绵状血管瘤血小板减少综合征	疾病
药品包装用复合膜	药物
烟肼丁醇片	药物
婴儿痤疮	疾病
情绪性多汗症	症状
手部功能完全丧失	症状
肝细胞内脂肪堆积过多	症状
甘露醇	药物
川贝止咳糖浆	药物
阿司米星	药物
土拉伦斯杆菌凝集试验	检查科目
口服补液盐I	药物
阴道上皮内瘤样变	疾病
泻药性便秘	症状
儿童清肺口服液	药物
娃娃宁	药物
柴黄胶囊	药物
体虱	疾病
大枫子油	药物
仙灵骨葆颗粒	药物
止咳枇杷合剂	药物
镰孢属	细菌
发热伴关节肿痛	症状
氯噻酮片	药物
月骨脱位及月骨周围脱位	疾病
舒康洗液	药物
纵隔浊音界扩大	症状
解毒降脂胶囊	药物
盲肠旁疝	疾病
雌三醇放免药盒	药物
云芝多糖胶囊	药物
木糖醇片	药物
加味逍遥片	药物
尿囊素铝片	药物
尿道瘘	症状
香菇多糖片	药物
奥沙普秦片	药物
病理性纵火	症状
马来酸桂哌齐特注射液	药物
小儿急性化脓性关节炎	疾病
桂附理中丸	药物
全鹿丸	药物
背部痉挛	症状
皮肤念珠菌病	疾病
发育迟缓	疾病
复方氢化可的松新霉素乳膏	药物
阴虚体质	症状
无乳链球菌	细菌
牙源性皮瘘	疾病
情景性晕厥	症状
决明山绿茶	药物
注射用苯巴比妥钠	药物
妊娠合并白血病	疾病
单硝酸异山梨酯注射液	药物
长城感冒片	药物
面部浮肿	症状
阿比多尔分散片	药物
记忆力障碍	症状
铜绿假单胞菌	细菌
小儿出血性休克和脑病综合征	疾病
并发症白内障	疾病
慢性肾衰竭	症状
急性出血坏死型胰腺炎	疾病
良性反应性改变	症状
急性淋巴细胞白血病	疾病
老人行动迟缓	症状
茵栀黄片	药物
铝尘肺	疾病
正柴胡饮合剂	药物
食管类癌	疾病
芬替康唑	药物
癔症性失声	疾病
维D2磷酸氢钙片	药物
氟吡汀	药物
血小板增多	症状
萘替芬	药物
知柏地黄口服液	药物
烧伤后无结石性胆囊炎	疾病
止咳定喘片	药物
急性虹膜睫状体炎	疾病
结肠平滑肌瘤	疾病
四季抗病毒胶囊	药物
复方穿心莲片	药物
胆囊触痛征	症状
胃复春片	药物
养阴生血合剂	药物
细菌性肺炎	疾病
阿莫罗芬	药物
六味地黄片	药物
感觉倒错	症状
睫状充血	症状
儿童期情绪障碍	疾病
松石丸	药物
丁非洛尔	药物
卡托普利缓释片	药物
阿莫地喹	药物
替米沙坦胶囊	药物
腕关节向尺侧偏斜时桡侧出现剧痛	症状
三味止咳片	药物
酒糟鼻	症状
小儿羚羊散	药物
痔出血	症状
脑脊液蛋白电泳	检查科目
眼球移位	症状
莱姆病	疾病
腕部疼痛	症状
食量增加	症状
唾液钠	检查科目
复方胃痛胶囊	药物
止泻灵片	药物
清金理嗽丸	药物
老年人肺栓塞	疾病
润滑剂	NoneType
醋酸甲萘氢醌	药物
包皮阴茎头炎	疾病
灿烂弧菌	细菌
珠蛋白锌胰岛素	药物
真菌	NoneType
阿莫西林分散片	药物
小儿七星茶冲剂	药物
氧化樟脑	药物
喹那普利	药物
咪唑酯	药物
小儿两性畸形	疾病
肝小静脉闭塞症	疾病
维U颠茄铝胶囊II	药物
卡莫司汀注射液	药物
生物元素	NoneType
罗布麻叶冲剂	药物
肺棘球蚴病	疾病
新复方大青叶片	药物
咪喹莫特	药物
结核菌素皮内试验	检查科目
上海市营养学会	NoneType
髂腹股沟神经干痛	疾病
小儿清热镇惊散	药物
乙酰唑胺片	药物
空肠弯曲杆菌	细菌
纸样胎儿	症状
巨大芽胞杆菌	细菌
红花黄色素	药物
盐酸头孢他美酯胶囊	药物
葡萄糖酸钙维D2咀嚼片	药物
盐酸芬氟拉明	药物
富马酸依美斯汀滴眼液	药物
小儿食管化学性烧伤	疾病
糖化血清蛋白	检查科目
复方喜树碱贴片	药物
江苏省心理学会	NoneType
不能转颈	症状
鸡血藤胶囊	药物
斯特奇-韦伯综合征	疾病
海绵窦血栓	疾病
风湿性心脏病	疾病
木瓜药酒	药物
中老年饮食营养与保健	NoneType
慢性膀胱炎	疾病
柯莱斯骨折	疾病
伤寒vi多糖疫苗	药物
香砂养胃软胶囊	药物
维奥欣	药物
盐酸雷尼替丁胶囊	药物
参归养血口服液	药物
壮骨关节胶囊	药物
慢性淋巴细胞性甲状腺炎	疾病
注射用环磷腺苷	药物
复方硫酸新霉素滴眼液	药物
约氏乳杆菌	细菌
注射用夫西地酸钠	药物
五酯胶囊	药物
光明盐四味胶囊	药物
乙酰半胱氨酸泡腾片	药物
复合磷酸氢钾	药物
口干燥症	疾病
普鲁卡因胺	药物
复方三维右旋泛酸钙糖浆	药物
胸腺肽肠溶胶囊	药物
胰胆汁综合征	疾病
板蓝根咀嚼片	药物
眩晕	疾病
克鲁米松通乳膏	药物
多囊卵巢综合征	疾病
健脑补肾口服液	药物
体内血小板活化标志物	检查科目
口角向外的放射性皱纹	症状
眼睑皮肤弛缓症	疾病
蠕虫病毒Win32.WombleFamily	NoneType
盐酸萘福泮片	药物
索立夫定	药物
空气栓塞	疾病
牙釉质腐蚀	症状
安乃近滴鼻液	药物
克补片	药物
毒蕈中毒	疾病
视网膜Roth斑	症状
小儿氨酚黄那敏颗粒	药物
巴氯芬片	药物
椎管内脊膜瘤	疾病
氟哌啶醇片	药物
十四味羌活风湿酒	药物
急性胃肠炎	疾病
复方间苯二酚水杨酸酊	药物
健康线异常	症状
青霉素V钾颗粒	药物
老年人扩张型心肌病	疾病
阿司匹林锌胶囊	药物
癫痫平片	药物
苯唑西林钠片	药物
微量元素	NoneType
卵巢功能异常综合征	疾病
顺苯磺酸阿曲库铵	药物
齿龈肥厚	症状
桂灵丹	药物
维生素Bl片	药物
除湿止痒软膏	药物
肩袖损伤	疾病
小儿血小板释放功能缺陷性疾患	疾病
暗色丝孢霉病	疾病
感冒喷雾剂	药物
品行障碍	疾病
血清腺苷脱氨酶	检查科目
淋巴癌	疾病
咳嗽性晕厥	症状
口辣	症状
奉承心理	NoneType
磺胺醋酰钠	药物
清咽六味散	药物
流行性感冒	疾病
脑乐静口服液	药物
一水乳梨醇	药物
保心宁片	药物
寒湿泄泻	疾病
生乳片	药物
肠道转运障碍	症状
支原体	NoneType
短暂性大脑缺血性发作	疾病
杏丁注射液	药物
甲氧苄啶颗粒	药物
细菌感染	疾病
板蓝解毒注射液	药物
血清黏度	检查科目
偏执性妄想	症状
精氨洛芬颗粒	药物
桂美酸片	药物
子烦	疾病
新生儿期癫痫持续状态	症状
D二聚体	检查科目
毛囊炎	疾病
腹痛伴黄疸	症状
美芬丁胺	药物
猫喘音	症状
小儿脑水肿与颅内高压综合征	疾病
仰趾外翻	症状
骨骺点状发育不良	疾病
脐血	症状
富马酸比索洛尔片	药物
化石	NoneType
小儿月经过多	疾病
不能伸展拇指	症状
肾皮质髓质脓肿	疾病
去氢依米丁	药物
大脑萎缩	疾病
盐酸氟桂利嗪口服溶液	药物
注射用双氯芬酸钠盐酸利多卡因	药物
胎产金丹	药物
逼尿肌无反射	症状
心脏转移瘤	疾病
颅脑损伤	疾病
硝苯地平	药物
乳腺病	疾病
两条腿不一样长	症状
软产道异常	症状
老年人低钾血症	疾病
龙眼莲子羹	NoneType
开塞露	药物
特康唑	药物
蛇胆陈皮口服液	药物
酚麻美敏口服溶液(小儿用)	药物
注射用氯化钾	药物
硫酸软骨素片	药物
都梁丸	药物
胃安胶囊	药物
泌淋胶囊	药物
曲安奈德新霉素贴片	药物
小儿白细胞黏附分子缺陷Ⅱ型	疾病
克感利咽颗粒	药物
帆状胎盘	症状
心理年龄小于生理年龄	症状
注射用硫酸卡那霉素	药物
妇炎康片	药物
髓内肿瘤	疾病
烧伤创面焦痂提前潮解、脱落或出现虫咬样变化	症状
橘红痰咳煎膏	药物
体癣	疾病
喉肌无力	症状
小儿情感交叉擦腿综合征	疾病
老年人慢性肾盂肾炎	疾病
石榴健胃胶囊	药物
维洛沙秦	药物
硅碳银片	药物
正天胶囊	药物
玻璃体液化	疾病
儿咳糖浆	药物
康寿丸	药物
小儿抽动症	疾病
血卟啉注射液	药物
两下肺纹理增粗	症状
云南白药酊	药物
关节僵直	症状
新力正骨喷雾剂	药物
祖师麻风湿膏	药物
风湿马钱片	药物
复方莪术油栓	药物
双苓止泻口服液	药物
复方百部止咳糖浆	药物
舒肝快胃丸	药物
景天虫草含片	药物
口周湿疹	疾病
侧腹壁或后腰部有压痛	症状
小儿腹股沟斜疝	疾病
亮丙瑞林	药物
风寒感冒颗粒	药物
变形杆菌食物中毒	疾病
鼻翼厚	症状
注射用清开灵冻干	药物
促甲状腺激素	药物
童年情绪障碍	疾病
烫伤药膏	药物
小儿结核性胸膜炎	疾病
扁桃体癌	疾病
牙折	疾病
心血管疾病伴发的精神障碍	疾病
消风止痒冲剂	药物
神衰康颗粒	药物
羊藿三七片	药物
吸吮反射消失	症状
葡醛内酯片	药物
葛根素	药物
甲状腺微小癌	疾病
盐酸坦洛新缓释片	药物
复方地龙片	药物
热带性肺嗜酸粒细胞浸润症	疾病
肠道病毒71型感染	疾病
先天性胸骨后膈疝	疾病
躯体化障碍	症状
腰骶部皮肤多毛、异常色素沉着	症状
复方醋酸曲安西龙涂剂	药物
灵芝桂圆酒	药物
小儿肾上腺皮质与髓质增生并存综合征	疾病
妇科白凤口服液	药物
戊四硝酸酯片	药物
浓缩水牛角片	药物
鼠疫菌F1抗原	药物
盐酸吡硫醇胶囊	药物
舒筋定痛酒	药物
眼睑肿胀且呈淡绿色	症状
富马酸亚铁多库酯钠胶囊	药物
盐酸莫索尼定胶囊	药物
盐酸精氨酸注射液	药物
参芎注射液	药物
左羟丙哌嗪颗粒	药物
脑脊液铅	检查科目
感特灵片	药物
雌酮硫酸酯哌嗪	药物
注射用甲硝唑	药物
提毒散	药物
儿童七珍丸	药物
脉络宁注射液	药物
游戏	NoneType
内分泌功能减退	症状
美尔伪麻溶液	药物
阴囊下坠	症状
附桂骨痛颗粒	药物
可可碱	药物
奥洛他定	药物
手握物无力	症状
血友病	疾病
尿胆原增加	症状
致密性骨发育障碍	疾病
乳腺增生	疾病
木瓜酶肠溶片	药物
安神补气丸	药物
雅叫哈顿散	药物
肌肉假肥大	症状
尿沉渣管型	检查科目
抗痨颗粒	药物
盐酸头孢他美酯片	药物
肝内淤胆	症状
辟瘟片	药物
醋酸甲地孕酮胶囊	药物
季德胜蛇药片	药物
西立伐他汀	药物
氢吗啡酮	药物
低温性昏迷	症状
异丙嗪胆汁片	药物
反复发作右肺感染	症状
眼白过白	症状
四氯乙烯	药物
自闭症	疾病
胆源性急性胰腺炎	疾病
阻塞性黄疸	症状
化毒散	药物
磺啶新林胶囊	药物
二羟丙茶碱	药物
肺动静脉瘤	疾病
足跟的后上方疼痛的红色肿块	症状
琥珀酸舒马普坦片	药物
小腿和踝关节周围的紫红色瘀斑	症状
颈淋巴结炎	疾病
室性早搏	症状
血浆醛固酮	检查科目
桑毛虫皮炎	疾病
环心丹	药物
连蒲双清胶囊	药物
骨产道异常	症状
氟甲松龙	药物
金属性变色	疾病
老年人白细胞减少症和粒细胞缺乏症	疾病
心脑康片	药物
正常颅压脑积水	疾病
小儿扩张型心肌病	疾病
产力异常	症状
骨刺丸	药物
肌肉撞伤	症状
浆液脓性分泌物	症状
二氧丙嗪苯丙哌林片	药物
皮脂腺增生	疾病
肝区血管杂音	症状
伊立替康	药物
六味地黄膏	药物
生物素	药物
胃容纳性减弱	症状
生长激素缺乏症	疾病
慢肝解郁丸	药物
骨良性纤维组织细胞瘤	疾病
补中益气丸(浓缩丸)	药物
智育心理学	NoneType
单纯性下肢静脉曲张	疾病
复方硫洗剂	药物
灵砂	药物
毛细血管扩张性共济失调综合征	疾病
苯噻啶	药物
汗出如油	症状
异源内分泌综合征	疾病
桑枝颗粒	药物
头孢呋辛酯片	药物
调中四消丸	药物
小儿神经纤维瘤病	疾病
吡罗昔康肠溶片	药物
甲芬那酸片	药物
颈部怕前屈，怕仰伸	症状
神经失用	症状
咖啡因	药物
凝血因子功能的障碍	症状
脸红	症状
马来酸伊索格拉丁片	药物
益气祛痰合剂	药物
地美索酯	药物
阿普唑仑片	药物
腓肠肌痉挛	症状
依替福辛	药物
甲沟炎	疾病
氨基酸注射液	药物
盐酸曲唑酮片	药物
肺弃血	症状
废用性弱视	症状
扑尔敏片	药物
双胃	疾病
参芪温阳栓	药物
化脓性眼内炎	疾病
直肠炎	疾病
依地酸钙钠片	药物
全血锰	检查科目
牛黄醒消丸	药物
甘露六烟酯片	药物
小儿咳宁糖浆	药物
氯化钾控释片	药物
眼球偏斜	症状
银杏叶颗粒	药物
复发性多软骨炎	疾病
耳流脓	症状
三妙丸	药物
肝复乐	药物
硫前列酮	药物
磷霉素钙	药物
秋水健脾散	药物
性病性淋巴肉芽肿	疾病
布氏菌试管凝集反应用菌液	药物
皮脂腺异位症	疾病
脑肺吸虫病	疾病
枸橼酸铋雷尼替丁片	药物
紫桔止咳糖浆	药物
盐酸艾司洛尔	药物
葡萄糖耐量试验	检查科目
醋酸甲地孕酮分散片	药物
脉搏短绌	症状
聚合性痤疮	疾病
神经系统副肿瘤综合征	疾病
小儿肺出血-肾炎综合征	疾病
盐酸可乐定注射液	药物
乳腺炎	疾病
川芎茶调口服液	药物
止痢十五味丸	药物
美替沙腙	药物
盐酸吡硫醇	药物
多酶片	药物
冠心丹参颗粒	药物
腹主动脉动脉瘤破裂	疾病
小儿消食健胃丸	药物
地磁	NoneType
抗乙肝转移因子	药物
羟乙桂胺	药物
黑鬼豆油	药物
口齿含糊	症状
单纯性肾囊肿	疾病
光年	NoneType
尿免疫球蛋白	检查科目
纤维连接蛋白	检查科目
肝胆湿热	疾病
牛黄净脑片	药物
葡萄糖-6-磷酸脱氢酶缺乏症	疾病
固本益肠片	药物
隐球菌感染	症状
粘膜有粘着性白斑	症状
小儿马方综合征	疾病
呼吸窘迫综合症	症状
芙朴感冒胶囊	药物
坎地沙坦酯分散片	药物
普罗雌烯阴道胶丸	药物
葡萄糖鱼肝油乳剂	药物
山龙药酒	药物
富马酸托特罗定片	药物
髌骨骨折	疾病
色素痣	疾病
女贞子膏	药物
小儿维生素C缺乏病	疾病
眼前冒金花	症状
桂哌齐特	药物
恶性贫血	症状
糖尿病性周围神经病	疾病
侧卧时位于下侧鼻腔出现鼻塞	症状
长骨粗大	症状
游离三碘甲状腺原氨酸	检查科目
过劳死	疾病
复方岩连片	药物
羟甲烟胺	药物
抗中性粒细胞胞浆	检查科目
锌布片	药物
久痢丹	药物
双碘喹啉	药物
百草枯中毒	疾病
升华硫氯化氨基汞洗剂	药物
注射用磺巯嘌呤钠	药物
夏桑菊颗粒	药物
胰腺肉瘤	疾病
背脊痛	症状
肠溶空心胶囊	药物
小金胶囊	药物
急腹症	疾病
膈下脓肿	疾病
肢体肿胀	症状
骶骼筋膜脂肪疝	疾病
尿素贴膏	药物
复方醋酸氯己定栓	药物
发育不良痣	疾病
五白糕	NoneType
藿香水	药物
盆腔肿瘤	疾病
淤滞性皮下硬化症	疾病
因子	药物
金刚藤片	药物
美敏伪麻口服溶液	药物
银翘解毒口服液	药物
血浆蛋白检测试剂铜兰蛋白(CP)抗血清	药物
咽血管畸形	疾病
泮托拉唑	药物
金刚藤软胶囊	药物
己烯雌酚注射液	药物
健脾化滞锭	药物
包醛氧淀粉	药物
金莲花冲剂	药物
坤顺丸	药物
氨碘肽滴眼液	药物
鼻息肉	疾病
半硫丸	药物
木瓜酶肠溶胶囊	药物
普罗布考	药物
碘解磷定注射液	药物
硫酸镁注射液	药物
肝气犯肺	症状
冠心苏合滴丸	药物
老年人急腹症	疾病
霜样树枝状视网膜血管炎	疾病
股骨近侧端变宽	症状
高催乳素血症	疾病
氯普噻吨	药物
智力因素	NoneType
膝关节内侧肿胀青紫，局部剧痛	症状
第一心音亢进	症状
青石颗粒	药物
爪甲和甲床表现为纵行色素带	症状
益脂平胶囊	药物
急性化脓性根尖周炎	疾病
红细胞生成性原卟啉病	疾病
情感高涨	症状
皮肤搔痒	症状
利肺胶囊	药物
盐酸奥昔布宁口服溶液	药物
盐酸雷尼替丁口服溶液	药物
吡喹酮片	药物
牛痘疫苗致炎兔皮提取物注射液	药物
眼球会聚功能麻痹或痉挛	症状
琥乙红霉素颗粒剂	药物
胞磷胆碱	药物
结核性腹膜炎	疾病
氧化锌	药物
肝素	药物
蚓激酶肠溶胶囊	药物
硫代硫酸钠注射液	药物
双下肢可凹陷性水肿	症状
巯甲丙脯酸肾损害	疾病
腓肠肌强直收缩并有疼痛	症状
咳平胶囊	药物
盐酸乙胺丁醇	药物
金钱白花蛇药酒	药物
安君宁	药物
氢溴酸右美沙芬溶液	药物
复方山莨菪碱滴眼液	药物
断血流片	药物
温经颗粒	药物
表皮松解性棘皮瘤	疾病
运动性疲劳	症状
鸡胸	疾病
小儿黏多糖贮积症	疾病
尿精	疾病
纤维毛囊瘤	疾病
牛磺酸散	药物
复方垂盆草颗粒	药物
康媛颗粒	药物
藻酸双酯钠片	药物
眼外转移	症状
营养不良性水肿	症状
痰火扰心	疾病
复方福尔可定溶液	药物
理气舒心片	药物
烟酸缺乏	疾病
营养性贫血	疾病
白天不自觉地将牙咬紧	症状
骨纤维异样增殖症	疾病
煎厥	疾病
氨酚伪麻分散片	药物
阴道持续少量流血	症状
髋关节积液	症状
溃疡病大出血	疾病
阵发性夜间呼吸困难	症状
蝎子螫伤	疾病
注射用血管紧张素	药物
胆舒滴丸	药物
氟哌啶醇注射液	药物
苯佐那酯	药物
感冒通片	药物
氨酚美伪麻片与苯酚伪麻片	药物
贲门癌	疾病
小儿46-XY单纯性腺发育不全综合征	疾病
虚喘	疾病
咽畸胎瘤	疾病
复方八维甲睾酮胶囊	药物
脑外科	医学专科
乳汁郁结	症状
解毒护肝颗粒	药物
复方桐叶烧伤油	药物
原发性脑干损伤	疾病
直肠癌	疾病
血脉清片	药物
甲氰咪胍片	药物
撕脱骨折	疾病
剧烈运动后腰痛	症状
德都红花七味丸	药物
水杨酸甲酯气雾剂	药物
胃内压增加	症状
治糜灵栓	药物
中央性颌骨癌	疾病
搭肩试验阳性	症状
获得性免疫缺陷综合征的神经系统损害	疾病
硫酸软骨素A	药物
共同性斜视	疾病
全身骨骼肌收缩	症状
第Ⅰ型脊髓血管畸形	疾病
抗病毒滴丸	药物
严重急性呼吸综合征	疾病
狼疮丸	药物
泛昔洛韦	药物
注射用硫辛酸	药物
Marie-Bamberger综合征	疾病
甲亢合并妊娠	疾病
咽旁间隙感染	疾病
小指半月甲呈粉红色	症状
漏斗骨盆	症状
女性癫痫	疾病
伤复欣喷雾剂	药物
毛囊皮脂腺囊性错构瘤	疾病
美索巴莫片	药物
肛膜闭锁	疾病
中华跌打酒	药物
脐带过短	症状
老年人慢性淋巴细胞白血病	疾病
活络止痛丸	药物
波替单抗	药物
那可丁糖浆	药物
醋酸地塞米松粘贴片	药物
希明婷片	药物
选择性培养基	NoneType
辛伐他汀滴丸	药物
内出血	症状
复方党参片	药物
硫酸小诺霉素口服液	药物
室管膜肿瘤	疾病
小儿急性肠系膜淋巴结炎	疾病
稀莶丸	药物
暴饮暴食	症状
虫草清肺胶囊	药物
麻仁滋脾丸	药物
红细胞碱粒凝集试验	检查科目
葡萄糖酸锌片	药物
华山参滴丸	药物
氯唑沙宗	药物
复方愈酚麻黄糖浆	药物
左、右腰腹痛	症状
布洛芬乳膏	药物
粒细胞减少	症状
Ⅳ型肾小管性酸中毒	疾病
小儿弹性假黄瘤	疾病
产后血虚热	疾病
鼠伤寒沙门菌	细菌
浑身酸痛	症状
士的宁中毒	疾病
肥胖性生殖无能综合征	疾病
网状色素沉着斑	症状
蛋氨酸	药物
肝火	症状
众生丸	药物
妊娠合并硬皮病	疾病
小儿再发性腹痛	疾病
黑头粉刺	症状
硝酸益康唑溶液	药物
鼻窦炎	疾病
人参药酒	药物
复听	症状
腹壁切口处有肿物突出	症状
双链酶皮内试验	检查科目
绒毛膜促性腺激素放免药盒	药物
动脉瘤	疾病
联苯苄唑涂膜	药物
短头畸形	症状
小儿退热口服液	药物
奥芬那君	药物
口炎胶囊	药物
和肝利胆糖浆	药物
谷维素注射液	药物
阿扎胞苷	药物
司坦唑醇	药物
吡诺克辛钠	药物
慢性硬化性颌骨骨髓炎	疾病
破伤风抗体诊断试剂(血凝法)	药物
抗扁桃腺炎合剂	药物
消炎片	药物
碳酸镁	药物
过氧化酶染色	检查科目
血影细胞性青光眼	疾病
小儿安乃近灌肠液	药物
渗出性胸水	症状
人血白蛋白	药物
脸裂	症状
外周围血淋巴细胞浆有空泡	症状
健民咽喉片	药物
静脉栓塞	症状
热干面	NoneType
胍那决尔	药物
泌尿道肿瘤	疾病
下丘脑综合征	疾病
心胸外科	医学专科
氯霉素搽剂	药物
建曲	药物
梅毒肝	症状
下唇微痒增大如蚕茧硬结	症状
阿桔片	药物
盐酸布比卡因	药物
氯雷他定胶囊	药物
军团菌病	疾病
痣细胞	症状
气腹痛	疾病
盐酸克仑特罗气雾剂	药物
蛋白丧失胃肠综合征	疾病
小儿肠胃康颗粒	药物
腰腿痛	疾病
哌库溴铵	药物
血浆蛋白检测试剂兔抗人血清	药物
盐酸丁咯地尔注射液	药物
玻璃酸钠滴眼液	药物
行为动作幼稚愚蠢	症状
全血铁	检查科目
畸胎瘤	疾病
上消化道出血	疾病
法莫替丁	药物
雌三醇	药物
肾血流量	检查科目
绒促性素	药物
外伤性脾破裂	疾病
风痹	疾病
痹证	疾病
EB病毒	病毒
促卵泡素	药物
四肢血管损伤	疾病
积滞	疾病
地图样骨缺损	症状
玫瑰糠疹	疾病
骨化性纤维瘤	疾病
氨酚氯雷伪麻缓释片	药物
泪囊肿瘤	疾病
重症肌无力样综合征	疾病
门冬氨酸钾镁注射液	药物
螺菌病	疾病
肺源性呼吸困难	症状
硫酸头孢噻利	药物
胚胎发育慢	症状
甘和茶	药物
特发性关节痛综合征	疾病
闭孔疝	疾病
木糖醇氯化钠注射液	药物
头孢米诺钠	药物
弹钢琴指(趾)征	症状
无痛性尿血	症状
茵山莲颗粒	药物
脉血康胶囊	药物
咽部脊索瘤	疾病
益气补血片	药物
高铁血红蛋白还原试验	检查科目
脑脊液神经肽	检查科目
牙齿黑斑	症状
右吗拉胺	药物
HBV与HCV重叠感染	症状
氯气中毒	疾病
西地碘	药物
百梅止咳糖浆	药物
产后逐瘀胶囊	药物
单侧鼻腔阻塞	症状
注射用油酸胆胺酯	药物
功劳去火片	药物
参贝北瓜膏	药物
盐杆菌属	细菌
咽部及颈部食管闭合性损伤	疾病
单纯性寰枢椎脱位	疾病
低血糖症	疾病
短腰畸形	疾病
景天清肺胶囊	药物
α1抗胰蛋白酶缺乏性肝病	疾病
多种钙维片	药物
弱蛋白银	药物
术后腹胀	症状
喷替酸	药物
阴道白斑	疾病
屏幕脸	疾病
原发性血小板增多症	疾病
剧痒	症状
膜性结膜炎	疾病
米诺地尔	药物
舒筋止痛酊	药物
鼻炎康片	药物
大泡性角膜病变	疾病
下鼻甲或中鼻甲肥大	症状
维生素A棕榈酸酯	药物
五维赖氨酸片	药物
糠酸莫米松	药物
吡诺克辛	药物
液气胸	症状
滑膜液肉眼检查	检查科目
并指畸形	疾病
十香暖脐膏	药物
胃纳呆滞	疾病
芦笋颗粒	药物
脑干梗塞	疾病
盐酸二氧丙嗪	药物
生血片	药物
曲霉菌病	疾病
香菊感冒颗粒	药物
急性脂肪皮肤硬化症	疾病
长Q-T间期综合征	疾病
启脾丸	药物
复方麝香注射液	药物
小儿变应性鼻炎	疾病
局限性肌张力障碍	症状
十全大补丸浓缩丸	药物
慢性腰背痛	疾病
小儿神经皮肤综合征	疾病
科学	NoneType
盐酸地尔硫卓缓释微丸	药物
鼻血管瘤	疾病
阿片粉	药物
休克较久后的肺部病变	症状
当归芍药胶囊	药物
多中心性网状组织细胞增生症	疾病
心复康胶囊	药物
玉屏风滴丸	药物
长春烫伤膏	药物
清便丸	药物
房室折返性心动过速	疾病
乳房湿疹	疾病
齐墩果酸	药物
史密斯骨折	疾病
出现毒性颗粒	症状
苏子降气丸	药物
肺转移瘤	疾病
环苯扎林	药物
数目较多的咖啡牛奶斑	症状
银芩胶囊	药物
穿透性角膜移植术所致青光眼	疾病
先天性肾病综合征	疾病
偶氮蓝	药物
扁平足	疾病
复方水杨酸甲酯乳膏	药物
中华肝灵胶囊	药物
羊痫风癫丸	药物
盐酸环丙沙星滴眼液	药物
骨关节炎	疾病
硫糖铝小檗碱片	药物
活性炭	NoneType
皮肤或粘膜上附着高锰酸钾结晶	症状
中毒性高铁血红蛋白血症	疾病
鼻渊合剂	药物
吲哚洛尔片	药物
五加更年片	药物
血红蛋白尿	症状
羧甲司坦	药物
孕晚期腹痛	症状
肝病	疾病
伤寒沙门氏菌	细菌
心达康片	药物
急性肺水肿	疾病
甘露茶	药物
耳聋片	药物
酪酸梭状芽胞杆菌制剂	药物
小儿止泻安颗粒	药物
中风回春胶囊	药物
苯碘达隆	药物
味觉减退	症状
筋骨草胶囊	药物
积液乳酸脱氢酶	检查科目
柠檬色痰	症状
附子理中口服液	药物
左边脸颊长痘	症状
紫龙金片	药物
脐尿管囊肿及脐尿管瘘	疾病
间苯二酚	药物
青羚散	药物
普卢利沙星胶囊	药物
氢溴酸后马托品	药物
下肢深静脉血栓形成	疾病
急性梗阻性化脓性胆管炎	疾病
抗生菌	NoneType
金荞麦咀嚼片	药物
肺宁口服液	药物
感觉过度	症状
阿昔莫司	药物
玉泉颗粒	药物
大腿以下或膝以下肌肉瘫痪	症状
维生素C丸	药物
麝雄至宝丸	药物
输尿管炎	疾病
桔梗冬花颗粒	药物
联苯双脂	药物
脓包疮	疾病
暑热感冒冲剂	药物
双向性室性心动过速	疾病
便秘伴剧烈腹痛	症状
螺内酯片	药物
避孕后闭经综合征	疾病
注射用苯妥英钠	药物
耆鹿逐痹口服液	药物
骨宁注射液	药物
童康片	药物
健延龄	药物
鼠疫菌F1抗体诊断试剂(血凝法)	药物
继发性皮肤CD30阳性大细胞淋巴瘤	疾病
月见草油软胶囊	药物
古楼山跌打丸	药物
眼底发现黄斑呈带灰色变色	症状
衣原体检测试剂盒(胶体金法)	药物
环拉酸钠	药物
补白颗粒	药物
乙哌立松	药物
维生素B4片	药物
脊神经根受损	症状
痰中或可找到蛔蚴或虫卵	症状
肛周软瘊	症状
盐酸文拉法辛胶囊	药物
老年人过敏性紫癜	疾病
老年人感染性休克	疾病
胎心率改变	症状
腰大肌脓肿	症状
炭疽病	疾病
良附丸	药物
踝部凹陷性水肿	症状
盐酸米多君	药物
蛋白S抗原	检查科目
支气管痉挛	症状
狂犬病免疫球蛋白	药物
小儿复方磺胺甲恶唑片	药物
耻骨上痛	症状
口唇潮红	症状
葛根芩连颗粒	药物
青春危险期	症状
始基囊肿	疾病
痢特敏颗粒	药物
复方氢氧化铝镁片	药物
无动性缄默	症状
老年人支气管扩张	疾病
七制香附丸	药物
萘夫西林	药物
根瘤菌	细菌
消肿橡胶膏	药物
夜间肩痛	症状
复方感冒灵胶囊	药物
葡甲胺	药物
竹沥膏	药物
酚咖麻敏胶囊	药物
源码型病毒	NoneType
自发性脑室内出血	疾病
局部麻醉药中毒	疾病
对乙酰氨基酚混悬液	药物
骨病	疾病
红细胞表面电荷	检查科目
硝酸咪康唑胶囊	药物
瞳孔中能见到白色反光	症状
美容	NoneType
急性感染性心内膜炎	疾病
盐酸克伦特罗片	药物
急性化脓性胆管炎	疾病
焦虑致胸口痛	症状
肺过度充气	症状
代号红色2病毒	NoneType
培哚普利叔丁胺盐	药物
大株红景天注射液	药物
坦克	NoneType
胃乐片	药物
海龙蛤蚧口服液	药物
哕	疾病
心肌梗塞并发左心室室壁瘤	疾病
感冒疏风丸	药物
逍遥丸浓缩丸	药物
足菌肿	疾病
二十五味绿绒蒿丸	药物
清热祛湿冲剂	药物
帕罗西汀	药物
腹泻	疾病
下消化道出血	疾病
急性脊髓炎	疾病
乙型肝炎病毒表面抗体诊断试剂盒(放射免疫法)	药物
先天性鼻咽部狭窄及闭锁	疾病
口唇刺痛	症状
多形性腺瘤	疾病
赖氨酸	药物
骨刺平片	药物
视瞻昏渺	疾病
先天性垂直距骨	疾病
亚硫酸氢钠	药物
大肠平滑肌肉瘤	疾病
噎膈	疾病
感冒清片	药物
手外伤	疾病
新生儿泪囊炎	疾病
血虚	症状
前列腺异位	疾病
阿洪病	疾病
鼻塞	症状
替克洛占	药物
醋磺己脲	药物
乙状结肠扭转	疾病
单纯疱疹性脑炎	疾病
卡托普利片	药物
肩背部沉重感	症状
黑舌	疾病
磺胺甲氧嗪	药物
乙酰水杨酸锌	药物
钩蚴性皮炎	症状
肾宝糖浆	药物
载脂蛋白B	检查科目
脾氨肽口服冻干粉	药物
淋菌性肛门直肠炎	疾病
戊型肝炎病毒IgG抗体酶免检测试剂盒	药物
刺五加脑灵胶囊	药物
功能性聋	疾病
环磷酰胺	药物
癫痫性精神障碍	疾病
高血氮	症状
穿心莲内酯滴丸	药物
头孢丙烯分散片	药物
明目滋肾片	药物
假结核结节	症状
蔷薇疹样皮疹	症状
盐酸氯雷他定胶囊	药物
柳胺酚片	药物
眼缺陷	症状
尿素乳膏	药物
卡络磺钠片	药物
小儿支气管扩张	疾病
原发性胆汁性肝硬化	疾病
头颈部剧痛	症状
乳酸依沙吖啶溶液	药物
糠酸莫米松乳膏	药物
心脑血管意外	症状
乙酰乌头碱片	药物
蝮蛇抗栓酶	药物
急性肾小管间质性肾炎	疾病
皮肤黏膜紫斑	症状
注射用他唑巴坦钠/哌拉西林钠	药物
下腹坠痛	症状
支气管脓性分泌物增多	症状
泻痢消胶囊	药物
护肝片	药物
金钱胆通口服液	药物
毛细血管脆性试验	检查科目
复方杏香兔耳风片	药物
代温灸膏	药物
剧烈头痛	症状
人参北芪片	药物
益心酮	药物
肌腱炎和腱鞘炎	疾病
鳖甲煎丸	药物
关节囊松弛	症状
盐酸伊托必利胶囊	药物
热毒清锭	药物
脐炎	疾病
盐酸赛庚啶	药物
复方牙痛酊	药物
滑膜增厚	症状
塞隆风湿胶囊	药物
微量元素缺少	症状
芩暴红止咳口服液	药物
复芪止汗颗粒	药物
蚕豆病	疾病
脸上长斑	症状
不完全性房内阻滞	症状
双贝特	药物
黄氧化汞眼膏	药物
脑脉泰胶囊	药物
上唇附近，鼻旁沟和眼睑的丘疹或结节	症状
多形性日光疹	疾病
阿苯片	药物
原发性鼻腔淋巴瘤	疾病
局灶性肾小球硬化症	疾病
二氟尼柳	药物
白带净胶囊	药物
尾部疼痛而拒坐	症状
贝诺酯散	药物
水、电解质紊乱伴发的精神障碍	疾病
传染病报告卡	NoneType
喉插管损伤	疾病
三硅酸镁片	药物
复方青果颗粒	药物
伤湿解痛膏	药物
手的搓丸样动作	症状
裸花紫珠合剂	药物
支气管结石	疾病
排尿障碍	症状
奇脉	症状
稳压胶囊	药物
特禀体质	症状
指甲-骨四联征	症状
假单胞菌	细菌
烧伤创面粪臭味分泌物	症状
鞭虫病	疾病
盐酸氨基葡萄糖胶囊	药物
肾骨胶囊	药物
类固醇肌病	疾病
嗜麦芽窄食单胞菌	细菌
比伐卢定	药物
睾丸畸形	疾病
皮肤皲裂	症状
盐酸舒托必利注射液	药物
六味地黄颗粒	药物
盐酸奈福泮胶囊	药物
骨科	医学专科
肘内翻畸形	疾病
小儿腹泻宁袋泡剂	药物
支气管结石症	疾病
盐酸托哌酮	药物
大活络丹	药物
尼立达唑	药物
己酮可可碱肠溶片	药物
性欲减退	疾病
面容呈灰色	症状
汉桃叶片	药物
胃肠气胀	症状
沙雷菌肺炎	疾病
咽角化症	疾病
频繁遗精	症状
淋巴道转移	症状
逍遥片	药物
复方鱼腥草胶囊	药物
氯氮平	药物
杏仁止咳颗粒	药物
肉杆菌属	细菌
兰索拉唑胶囊	药物
假性延髓性麻痹	症状
乌鸡白凤颗粒	药物
心理教练	NoneType
酮洛芬肠溶片	药物
肱骨远端全骺分离	疾病
盐酸金刚烷胺	药物
小儿内脏幼虫移行症	疾病
枕叶肿瘤	疾病
小儿洋地黄中毒	疾病
甲氧西林	药物
冠状动脉异位起源	疾病
隐球菌病胶乳凝集试验	检查科目
小儿清解颗粒	药物
维生素B6缓释片	药物
输血后血小板减少性紫癜	疾病
胃火口臭	症状
脊髓的浸润	症状
胃肠道淤血	症状
骨刺消痛液	药物
心安宁胶囊	药物
雷公藤多甙	药物
钩回发作	症状
肌肉挛缩	症状
